sequence,label,command,pending count,ebilling count,csh count,total count,sessions
d+cN!TO]C,0,"['Lock SSH directory', 'Save SSH key', 'Get CPU counts', 'change password', 'Remove security features', 'Get CPU info', 'Get memery info', 'Get where ls is', 'Get system info']",0,0,1,1,['d0e115f1f6b1']
d+cNZNTO]C@*c<CCMK9,0,"['Lock SSH directory', 'Save SSH key', 'Get CPU counts', 'change password', 'password prompt', 'change password', 'Get CPU info', 'Get memery info', 'Get where ls is', 'Get system info', 'Get crontab deamon process', ""Get logged user's activity"", 'Get CPU counts', 'Get running processes', 'Get system info', 'Get system info', 'Get current username', 'Get CPU model', 'Get file system size']",1,1,0,2,"['529aa4056902', '0267297203f4']"
d+cNZNTO]C@*,0,"['Lock SSH directory', 'Save SSH key', 'Get CPU counts', 'change password', 'password prompt', 'change password', 'Get CPU info', 'Get memery info', 'Get where ls is', 'Get system info', 'Get crontab deamon process', ""Get logged user's activity""]",0,1,7,8,"['35dd3035bbc8', 'cce787864f89', 'ea60992f219f', 'd10329b0ce96', 'c6394d5e1be8', 'cb1569c1e4e0', '25f1bab17ce4', 'a92fcd9a2b8c']"
d+cNZNTOC@*Cc<CCMK9,0,"['Lock SSH directory', 'Save SSH key', 'Get CPU counts', 'change password', 'password prompt', 'change password', 'Get CPU info', 'Get memery info', 'Get system info', 'Get crontab deamon process', ""Get logged user's activity"", 'Get system info', 'Get CPU counts', 'Get running processes', 'Get system info', 'Get system info', 'Get current username', 'Get CPU model', 'Get file system size']",1,0,0,1,['32481e35d2ba']
d+cNZNTO]Cc<CCMK9,0,"['Lock SSH directory', 'Save SSH key', 'Get CPU counts', 'change password', 'password prompt', 'change password', 'Get CPU info', 'Get memery info', 'Get where ls is', 'Get system info', 'Get CPU counts', 'Get running processes', 'Get system info', 'Get system info', 'Get current username', 'Get CPU model', 'Get file system size']",0,0,1,1,['778bb2aaef6b']
d+cNZNTO]C@*Cc<CC,0,"['Lock SSH directory', 'Save SSH key', 'Get CPU counts', 'change password', 'password prompt', 'change password', 'Get CPU info', 'Get memery info', 'Get where ls is', 'Get system info', 'Get crontab deamon process', ""Get logged user's activity"", 'Get system info', 'Get CPU counts', 'Get running processes', 'Get system info', 'Get system info']",1,0,8,9,"['f65ede6bff59', 'bb42945d84b8', 'c24da65d5779', 'b34a3f75de82', 'f965fbc00a0a', '28ee1a555861', 'e454dbee88ee', '53c5c296b3bc', '7eb6d538e203']"
d+cNZNTO]C@Cc<CCMK9,0,"['Lock SSH directory', 'Save SSH key', 'Get CPU counts', 'change password', 'password prompt', 'change password', 'Get CPU info', 'Get memery info', 'Get where ls is', 'Get system info', 'Get crontab deamon process', 'Get system info', 'Get CPU counts', 'Get running processes', 'Get system info', 'Get system info', 'Get current username', 'Get CPU model', 'Get file system size']",1,0,0,1,['c46fd439699c']
d+c!O@*Cc<K9,0,"['Lock SSH directory', 'Save SSH key', 'Get CPU counts', 'Remove security features', 'Get memery info', 'Get crontab deamon process', ""Get logged user's activity"", 'Get system info', 'Get CPU counts', 'Get running processes', 'Get CPU model', 'Get file system size']",1,0,0,1,['8305011e8d97']
d+cN!TO]C@*Cc<CCM,0,"['Lock SSH directory', 'Save SSH key', 'Get CPU counts', 'change password', 'Remove security features', 'Get CPU info', 'Get memery info', 'Get where ls is', 'Get system info', 'Get crontab deamon process', ""Get logged user's activity"", 'Get system info', 'Get CPU counts', 'Get running processes', 'Get system info', 'Get system info', 'Get current username']",0,0,1,1,['03257441d1c2']
d+cNZNTO]C,0,"['Lock SSH directory', 'Save SSH key', 'Get CPU counts', 'change password', 'password prompt', 'change password', 'Get CPU info', 'Get memery info', 'Get where ls is', 'Get system info']",1,0,7,8,"['2bf99897563a', 'c6e6697a8aab', '796a5f856adf', '387f08a3754e', '2e7947c68c2f', 'fcae34e34575', '5749480eef4e', '738cc5f8cfdc']"
+cNZNTO]C@*Cc<CCMK9,0,"['Save SSH key', 'Get CPU counts', 'change password', 'password prompt', 'change password', 'Get CPU info', 'Get memery info', 'Get where ls is', 'Get system info', 'Get crontab deamon process', ""Get logged user's activity"", 'Get system info', 'Get CPU counts', 'Get running processes', 'Get system info', 'Get system info', 'Get current username', 'Get CPU model', 'Get file system size']",1,0,1,2,"['b1e3e20cc6e0', 'd7b4fc464fae']"
d+cNZNTO]C@*CcCCMK9,0,"['Lock SSH directory', 'Save SSH key', 'Get CPU counts', 'change password', 'password prompt', 'change password', 'Get CPU info', 'Get memery info', 'Get where ls is', 'Get system info', 'Get crontab deamon process', ""Get logged user's activity"", 'Get system info', 'Get CPU counts', 'Get system info', 'Get system info', 'Get current username', 'Get CPU model', 'Get file system size']",1,1,0,2,"['2311af225df9', '97ffc74e34dc']"
d+cN!TO]C@,0,"['Lock SSH directory', 'Save SSH key', 'Get CPU counts', 'change password', 'Remove security features', 'Get CPU info', 'Get memery info', 'Get where ls is', 'Get system info', 'Get crontab deamon process']",1,0,4,5,"['8d352c15640b', '88c5cdb2e05e', '5cb0c5d2cc17', 'd58c848be25f', '002baf7873b0']"
d+cNZNTO]C@*Cc<CMK9,0,"['Lock SSH directory', 'Save SSH key', 'Get CPU counts', 'change password', 'password prompt', 'change password', 'Get CPU info', 'Get memery info', 'Get where ls is', 'Get system info', 'Get crontab deamon process', ""Get logged user's activity"", 'Get system info', 'Get CPU counts', 'Get running processes', 'Get system info', 'Get current username', 'Get CPU model', 'Get file system size']",1,0,0,1,['985c0eb185b0']
d+cNZNTO]C@*Cc<C,0,"['Lock SSH directory', 'Save SSH key', 'Get CPU counts', 'change password', 'password prompt', 'change password', 'Get CPU info', 'Get memery info', 'Get where ls is', 'Get system info', 'Get crontab deamon process', ""Get logged user's activity"", 'Get system info', 'Get CPU counts', 'Get running processes', 'Get system info']",0,1,9,10,"['7d2355040171', 'df13825d4829', '92cc3d73fa5d', 'f7e84a23c305', 'ec835343ba16', 'f3f3e09043c3', '3eadb2e75b14', 'e240fe5531dc', '2a25e52c625f', 'f206abec37bd']"
d+cN!TO]C@*Cc<CCM9,0,"['Lock SSH directory', 'Save SSH key', 'Get CPU counts', 'change password', 'Remove security features', 'Get CPU info', 'Get memery info', 'Get where ls is', 'Get system info', 'Get crontab deamon process', ""Get logged user's activity"", 'Get system info', 'Get CPU counts', 'Get running processes', 'Get system info', 'Get system info', 'Get current username', 'Get file system size']",1,0,0,1,['3d80ad6dd00e']
d+cN!TO]C@*Cc<,0,"['Lock SSH directory', 'Save SSH key', 'Get CPU counts', 'change password', 'Remove security features', 'Get CPU info', 'Get memery info', 'Get where ls is', 'Get system info', 'Get crontab deamon process', ""Get logged user's activity"", 'Get system info', 'Get CPU counts', 'Get running processes']",0,0,1,1,['13a2b72d6ee1']
d+cNZ]C@*Cc<CCMK9,0,"['Lock SSH directory', 'Save SSH key', 'Get CPU counts', 'change password', 'password prompt', 'Get where ls is', 'Get system info', 'Get crontab deamon process', ""Get logged user's activity"", 'Get system info', 'Get CPU counts', 'Get running processes', 'Get system info', 'Get system info', 'Get current username', 'Get CPU model', 'Get file system size']",0,1,0,1,['d1c6494889a4']
d+cZNTO]C@*Cc<CCMK9,0,"['Lock SSH directory', 'Save SSH key', 'Get CPU counts', 'password prompt', 'change password', 'Get CPU info', 'Get memery info', 'Get where ls is', 'Get system info', 'Get crontab deamon process', ""Get logged user's activity"", 'Get system info', 'Get CPU counts', 'Get running processes', 'Get system info', 'Get system info', 'Get current username', 'Get CPU model', 'Get file system size']",2,0,0,2,"['f0b3a4ad4fe9', '2a19523ab2aa']"
d+cNZNTO]C@*Cc<CCMK9,0,"['Lock SSH directory', 'Save SSH key', 'Get CPU counts', 'change password', 'password prompt', 'change password', 'Get CPU info', 'Get memery info', 'Get where ls is', 'Get system info', 'Get crontab deamon process', ""Get logged user's activity"", 'Get system info', 'Get CPU counts', 'Get running processes', 'Get system info', 'Get system info', 'Get current username', 'Get CPU model', 'Get file system size']",2909,1535,1368,5812,"['c180fdaa19ac', 'f8b7d534c427', 'b27ecef03bfa', 'd93c55fd3b81', 'd83ab027540d', '319a6ddd59f5', '9862c03f273b', '3eb722456a38', 'aff434297dcc', 'ed3684716806', 'aa8f73b682ea', '497f3dcc0fbb', 'e09ea973a540', '7bca1787b528', '1d223e2401ce', 'e0edcac3f393', 'a263ae6efe57', '45dc54618b1c', 'fb36c4548879', '005a25dfb56b', '6f62dc70eff7', '33eae30557eb', '4f522e0cc249', 'cf31d6867455', 'f5050fee3955', '3fb8c1d531b9', '7cff504175e3', '839489ba811d', '7a56039007e2', '667624cf4d28', '695db5bf1601', '87c40ba769b9', '3c7676b33b93', '25f17d9ed8af', 'ce548283767e', '729f8c47fc38', 'cfad7b2660e0', '75def87bacbd', 'e638bfb99513', 'd364800fbbf1', 'fb3e9a2bc0fc', 'a50726583918', '2e691e320dd8', '262855f1671d', '74222480fc85', 'd53e7e64139d', 'a6b9d364c6b2', 'f881e4fd9ac5', '7f673080e582', '023d5b205d2b', '2516757a9c71', 'a7cdc2265172', '546b34329203', '2b62c3357724', '6ca6952be256', '5ca7eb225cff', '97b44cd49a34', 'a17a3378cdfe', '1f3ee2c29f72', '74154aa02f8e', 'c012da9c4796', '0b482401f18f', '4361deddac8a', 'df5c2a179bd9', 'f60a39780068', '20609af624ce', 'dabe695cb7f7', '168faf6ac13e', '0ffd4b9d0b2c', '2f373ab4c5e7', 'c9ae77905a01', '0b89d63a08dc', '78d6df25785d', 'd5d1173917e3', 'bdbf661a7b8d', 'e3b7c53148c1', 'cea8f027129c', 'b85e7641d68c', '37ccec16de51', '1bb7ea0917b9', 'a5fd847d7bb4', 'd1f238ccc87b', 'f94f90c3dc7c', 'dd95700c7a64', '2aaea9bc0f88', '75ad1c289258', 'e3be28197c31', '9347ad4de179', 'f0b2df8c7c3c', 'c287a7622952', '36232a25de6a', 'ec44dfff4be1', 'c53325cd6996', '55a441b49b2d', 'a623b02db28f', 'c6818fe7fbcc', '2b4fff9bcad0', '05f5d02b1749', 'd6467a3d0a15', 'fdc5c7294aec', '9f19aea31421', '14643f2c07f2', '33d9ddfea315', 'a245981838b1', '85a91d9e1f80', 'f377b3bbc794', '6a4cbea4b60f', 'ebe8aa654b76', '7433bdb2299b', '3967cb23867c', 'f019df97b9ff', 'b9c4df848873', 'f78620d74a20', 'd15450502d1e', 'ec5e5395e0d2', '4edbcf27ca10', '26da7a74b7ca', '45849949dcbc', 'd8ca3e84b66f', '7934adc134c0', '5a7d53fec959', 'b8d1cf809c7a', '8fbfa32f835a', 'e3c3da8b1863', '442bb170e855', '36c205eaaa75', '05d5dbe0469e', 'a39f729eea31', '35e4099b84a4', '8246ac6414cb', '9627b832673a', 'b9d6ac798a79', '35ea6bf0604e', '100f35ec0306', 'e6d02025d140', '9668fd595be8', 'd4251a6e86d5', 'b25785b3208c', '713fc9df12c8', 'b649aae1565b', '4a91fd5d14bf', 'b3635e70eb0a', '0f28e9ec8cb0', 'db0f4ef4f4a9', 'c34a2fee4004', '60ea221684ea', 'a969c27d5d6d', 'd2b2281d3b11', '0dfcbeac4f8c', 'aa51544488a9', '5b063f7a9393', '83cde3bc0d4d', 'dd3b212ad18b', 'ac6c3b2b1466', '1aff3b0b2d7c', '56d6b02d99a2', 'a3ab5848de02', 'bd3247c5e328', '3e6acedae13f', 'e585877a9c22', '4606087fa3eb', 'dd0637bc6554', 'fdcae039af20', '10f9da16a16a', '3228dd297692', '61c5095569fc', '8e7a6dee0a5d', '61965ce9702e', 'a28e7d7091e9', '72b910d702a0', '4a787c06679f', '3092e4776c73', 'aa36cc8e6d0d', 'a374f6f019d0', '9dd24df0180a', 'fda23e9f72b2', 'd80c5203426a', 'fb72b3663712', '9f961f581dc5', '5e03e3ffcbeb', '785e23cd8171', 'fd3a6c52f164', 'ef4ad3c6cef9', '93b917dd18dc', '34ec8856bfc2', '12ec3d71cc4f', 'cb2ecfca7e41', '2abbe3febde3', 'd979ed1789ad', '9ad405c7feaa', '0bfcfd7aa796', '3c2ba3a3d1cb', '998f44f68d35', 'de87804e141d', 'ea11e13c441a', '3c1a559808e8', 'af484ab51045', '472144683bd4', '8df89909a392', '8715228bbecc', 'bed660094482', '9c45f7f301b0', '9793b01065e6', '74d45ad1cfb6', '0363bfb4e0d5', '0ee1fb6b0305', 'a9f22e6030d2', 'bc5dcb12b9a1', '1d7977548ce1', 'b38c486470fa', 'f2e4586555ec', '1e95e6973f34', '8626b298ca49', '0a784152f7ed', 'bda0714a054a', '731e74622188', 'f01ad4b43391', '30fb64927ce3', '1a6bcd4d21aa', '27c7ed82ea2d', '144966bb7114', '38b360bd64d0', '85ab8b1f7a11', '78199eb0e2b3', '66ba008ce108', '18bd760c6d04', 'e4fc357ff3d4', '597d331b0188', 'f533d15b6fab', 'ff606d1b3253', 'da7f0232d503', 'fb450392c210', 'bfe50b690f97', '53eac7848c4b', '1591981fc1d3', 'fe191f625d61', '01a8d6325d89', '8323a3903f96', 'bb221c89ec40', '7c91f1d52df4', '25aab74a9a61', 'a95b05a85454', '10da54c8c0a3', '401c434534d0', '08f61b6c003f', 'cd0f39d9f40e', '400fdc8e602b', '41446dbe126d', '5493ef6028af', '372e77cf5c07', '62b967d8b014', '599b445622c2', '1edd871b688b', '38edd636bc6c', '1161a66e8890', 'fa85592e029a', '5a625ed56222', 'c47b2ef24e4f', 'df60e5de9a3a', 'f1e3bc9c3ab2', 'ab408be9e406', 'b1b94d4e6a02', '20c9e4ad6dfb', 'ad8242d024f4', 'd280cd735819', '1ea8ad76240d', '3505b9342450', '047d890ae9db', '25256a7f3a6d', 'ff73fb9e41bd', 'd8e830c40078', '539976766cb5', '55fff5f413d7', '829d81606711', '0ce5773aa979', '5785447da362', '3ef049f121c5', 'beb8a7d86a93', '34866ea5727b', '0b40617e49ab', '340422f12ae3', '5e7951a62adc', 'a80b21050a26', 'b037a2c2c61d', '3153a0279947', 'b0f777434546', '74f71de56a26', 'f6b6464c3611', 'fb2d5fd5dfaa', '94990b326bd8', 'fe8fb845f0fd', '7357965b719c', 'f144f36b14ed', '427f81b58502', '516953da4252', 'be13ddcc5ece', '30e93c13de49', 'c68090e25cef', '6a597e1e631d', '0ee6c25d18b7', '05e94f640eb5', '2c421595aa7f', 'd34abeeb2d40', '221b26bb9b2a', 'cf3396451a69', '5c1914f1b348', 'f40347ed79e7', '07d2b200c8f6', 'b64f0ee958e3', '7d1ca3b9e63c', '4a6666773849', 'a7c70ce6083c', '674a7720d347', '503fc59487d7', '53689a273441', 'fa2510d730ec', '3ed587f2344e', 'e48d784d91b0', 'f1866f7a7fc8', '2ae37dd9a198', '11859dc35dd5', 'd438bb39179b', 'f37bde6092d5', 'bc2619bc9cff', 'e148e6f7b05f', '365836094532', 'd3f69484425a', '1dc0da20f1f4', '82b2b4d59561', '1fe57af68862', 'ca6ba2592005', 'e5ca6b3d8b8c', '4a36b3586d7d', '3196abbf8ccf', '1d372c12acf6', '3df1afb10170', '3e2e6a2e28e7', '06ad00d34446', '3f681e0cea22', '5a0c7d26552e', '58c55bd631ed', 'c91dd2f80ef7', '993be9332a8f', '3059a381f85e', 'fadfb4654965', '418976b6353a', 'e4c90d1044c1', 'e7032fbb23a8', 'd8bf92085d93', '0b7ec926d7fe', 'afaa481fab1c', '70e7d79d600d', 'e4d026e49648', '61efdac74434', 'fa93ad06443a', 'e1a4480a03cf', 'f917136af503', 'f2167012736a', 'ab9bac095cf2', 'c6fae1ccb5ce', 'ee87f9212779', '7ed78ff546f1', 'bc3fdc2d47e5', 'b34cb3591a31', '48f17e632201', '683212007aa0', '0f743e67cea1', 'dd7ce7dfb25a', 'dd60ed2fb1b4', 'eac9093b5d29', '1ac99da0acf1', '28b90c38fb63', '92a636298668', '6a87d9843075', 'd4c85c84af92', '93984f2cf966', '62897344ffa1', '6f13bf1161de', '72c2bf961137', '8a4a230f935e', 'eec84862b6c3', '7b5623d8c1f3', 'd40d01a5950e', 'f8188af900ae', '57f0846d4851', '6b1a0f9fe65b', '563d1692a0c0', 'e1c83dcc0464', '127975a4be9b', 'e6c085477f38', '348915d4323c', '590793bf36e8', '28d10ca0d67e', '16ac97697d29', '5d00c0c98c44', 'd927c632de21', 'edb9780608d1', 'b2af0cce9b27', 'e3b1f03964e7', '0eea70309d6b', 'bf73731d283c', '1744f68f1ba6', 'a2de8b547520', 'fdb2ac0e8d51', 'fbbc69c733a5', '242c817ffb36', '2911272f56c2', '1606ecdfe340', '123e15a332ee', '06da7a2d5fa3', '968b74cf15a2', '0e19fe4bd679', '4b5aedd4b3fe', '32966b74f3bc', '0f90ef1c8144', '99729246272c', 'e351779c6435', '28051fc76d37', '81aff47e48d2', '7d58b295b821', 'd5ba7fed2e20', 'c1d3a69c5391', '08284a3c760f', '87970ce801ed', '60cc3adb9731', 'feea40ac05cd', 'e3e63c4f194a', '26d7383c25b1', 'feaa02a9df9b', '5f6de83c2e85', '706b3d2a3a86', '061d533597cd', '05e103f678b3', '8ae6c9ac4897', '051202df7478', '76a9585086ad', '36399741d41b', '25e0f5469ec8', '5c6280bda942', '12f52d319f2c', '256483bd4a9b', '0e8272489bfb', '2962b10d1f0d', '438efbf68239', '6d738d890088', '01d9c608fb27', '39092b1ca5dd', 'a1cc42f94367', '32858b50d938', '0fccdafac034', '34fded287646', 'ad57d7529df8', 'afb84a77bac9', '28dfadefea82', 'a6521fe563ec', '14a2ac408320', '589b8b87fb85', '1430a89b1122', 'f3f2f7fb0c67', 'b587e60ea0df', 'eb6d84807d94', 'fac72f15724f', 'f31f50ff7200', '6b8672e97347', '8e6657bba2bf', '559a1243a7be', '2441f77d42f9', '58ee2dc012b9', 'a46b08645fc8', '1299a597780c', 'f6a1e08e0928', '6ce3a2c0443a', '283dc1bca3df', 'b44209fdab6c', '7d39ff4ed4fe', '2220532a91b0', '9acef5dcf93a', '2424559162d2', '383e850fcad7', '4edef883cefc', 'dd7cefecc6f6', '3cd6840d2d7b', 'edc472b60310', '1af6e985a191', '1a393cc4fd38', 'b47b9c60349f', 'dcd04ac4afb7', 'b16c3f232307', 'ee7b45243355', 'a53d28105ef1', 'b834bfcb9f42', 'a795d0e48f78', 'e08c3d5bb9fc', '2103c34f9bf5', 'a7ee3aa3b52e', '762e2ec17fde', '3430e76bc437', '6cae1b2fdf4b', '86caf9995196', 'b9fc7f65abe1', 'f021f40b4a6d', '234cbb64bb6d', '82f14c83cf44', '21ac52f22d30', '27eb331f2972', '48954ef66c2e', '5e656a0c085d', '08b0e732550b', '0cef4e07d604', '89bd1f7b1bcd', 'e2919c1901b2', '7e240653c6f8', '3c304c68c5ad', 'dd39c21a76de', 'a651cdc87140', 'edc5416fd7fa', '1a2ae3c55002', '038d621545ba', 'e0fd49a7dccb', '95a001ca0c29', '9197d0663d97', 'c2d26db38eb6', 'd788cf0d0860', 'e8ea5503433b', 'd18e386aeeb6', 'b6eb214b7f92', '35d752181a21', '06246dad0308', 'e3da06f081ec', 'ea5fcce5abb0', 'e8a0ac0c87b0', '3023f2b60680', 'bd39e70cda63', 'f74d70828e6f', '17ec08b50d9d', '080eaebcb2ab', '0c1f4b2b2267', '731944a65448', '492677ea41c2', '18ed23441f57', 'b6ef6827005d', 'cb890de450a3', '33bdcc2be61d', '86af5de57c75', 'ff7be0540d6f', '9230fd63ac59', '0f0bac17f921', '414c1a7a9319', '5c50dcabaf5f', 'edae578b80f6', '4f577d1629f4', 'ab669ff1c238', 'b4a5f9f12ac7', 'b5acb5011497', '7aac98fcf0dd', 'f3968b6acdca', '2ed738c9f078', '771c3e532bb3', '9cb29ec94b17', '468afa9cb973', '36924a752198', '28771f564914', '9b99cef6a89b', '6805c028c709', '3440465a2696', '99f61cbfe8cf', '830dd4946a11', 'cd8f8979b671', 'ea1cc1cde3d8', '94fe9bc298ef', '6ec4c4e41422', 'ac95ebd1e233', 'c07c5d855ebb', '1e2ab216de82', 'bc14494a256a', 'ad1201968124', '3d50f4e3acac', 'dd5c1d92ab93', '86605f20a7fb', 'c19405c7b127', '1436ac0adb60', '28cfb936e0c2', '35df1626ae03', '8a6129803113', 'd4ee8e8db511', 'a2e7e048823c', '2e7742832fae', '1568f8a8c431', '0c2065b0cdab', '9406cef79b21', '02672274e10f', 'bc24f160a6ac', '40b85f403fe6', 'fb6d5eb233a8', 'c5888c59d48c', '3d67aaec30e9', 'b287819143d9', '6c97a267151d', '8bf338e00a6f', '72cde254df61', 'd1e91c44c127', '9bf13eb8f4c8', 'ce014f67ff31', '66f786648524', '86ba44ddd2ac', '9eb88087dea7', '6fd6bab3c9db', '3cd4f0c4a0a8', 'eae10fd6bae5', '9ed5a224fbff', '179b342ff83f', '48d99927e21f', '446875d3d5f3', '8de3082b40f0', 'cc900b4df459', '4ea0b47f5c5f', '639b5f4767ce', '0d120387df1d', 'c05db5c14477', 'e7b5a6d3b9ee', '61d68212329e', 'e6e609db5165', '9dbc397631d6', '39ddc20c1dc5', '364efa3d8413', '2103e97c78a9', 'e329c207a05a', '2dc5f859061d', 'e4227f442c0c', 'c52577c47498', 'bed01451028b', '61d2b672b7d7', '777896a0d773', '9cf0ba2244b0', 'dbeaf7545951', 'a27aa3871a63', '26c856eaf235', 'c4fa7509d9dc', 'f3223c35e280', '8727e3591640', '8cf3bc724041', '4e7c0fd6bea0', '595c53a11841', '28b59fe04163', 'c25fe026e3d4', '716e706f3e4b', 'c964fda5000a', 'cc0ea5775464', 'f967e917fdcf', 'c09ceab9e6d6', '8b94dae2a51a', 'a8ff1dc15fbe', 'a4a11fdd0472', 'e362ed9efefc', '9c40e76f3620', '36bd2314b0d1', '1d431ebda2eb', 'aea32f40db3d', 'd2cf9eb94f85', 'f36e304a5d47', '69101b68e28a', '0a3a1f6cca32', 'f4be7f0728e4', 'e290843936e8', '602b0ef4c3f6', 'e12e26bafa2c', '907dc7c66632', 'd52889f6cb36', '52eac2b2eb18', '22131b4054a8', 'fd989652d332', '7f03be7d71b2', 'f06bc1978898', '5b79b1bafafb', '8329023c4f58', 'e86cf0a0ce87', '033db09cb87f', 'f174efbbd309', 'f4e302c18ccc', 'a25c7f6ff508', '55f89f5dd83a', 'bf9bb5d6a37a', 'fd64f6e1f707', '1f89811c85c8', 'caa932ca88e5', 'e70686b6f5a8', '0c66e7acd2ff', 'ad213b0f6351', '5a141e785c10', '1f1930275a93', '69adeaa8b6b2', '52a01c0bb81e', '30483e4919db', 'da01844b34a1', '8eaf6fa66419', 'e01a802df678', '19d147058772', 'bb6bc1c858bb', '7de75aef1b38', '50de70f41bad', '22f83d943764', '611b10f0978c', 'e780fbfee4f7', 'b328a1e39716', 'dbf09849c6f6', '69307d03ee8b', 'b56f88a8cea5', 'ec132afffe56', 'fa5441b20398', 'c33601ec3e89', 'b3972a92dc80', '962a591169ff', '83d2a6518e54', '6f6bb443924e', 'fd466abb9cc7', 'e1439e968705', '9472fa59c541', 'ba0bbf72ecb0', '5c80103610de', 'ddecb43ae9b0', '8c58e8468181', '96fc7a4e1d8b', '723e97cae2fa', '5b0152db0283', '8f8daa5fb66f', '8326ba8d1677', 'a4d3fb30bc15', '19f921076fe9', 'a291f1826369', '8835ea108173', 'efb4ad682453', '181ff00764e6', 'e21f7ba7856d', '73877f02a6aa', '42b743185dfa', '16184fe300ab', '93db3115536e', '649ac2ffa50d', '5a09a85e5500', 'c8c671642df4', 'dc6c6b2b21ef', 'd3f0d91933fc', '9a249ae5912f', 'c2bfae68657f', '141e6d6aaff4', 'fadf04176b44', '6d6f6e7be3c7', '668fd8c6ecd1', '1c415eec7033', 'd3e909489974', '6dc807bf0001', 'fcb9546aa96b', '87704356fbda', 'ccb509bea182', 'b5e541ff6759', 'fcf82445d945', '43cf6a6ff4dd', '99dba51b0b94', '6f0bfc8349ff', 'c6368d873cd7', '66281f308e19', '8de2933feaf4', 'e3b4f3a3db6d', '4788965f4e87', '07edfe2ca3aa', 'a5b6246f8eb7', '716751ef5a7f', '6ef0aa8db755', '5c1de3095b69', '59b7eb0402a9', 'af7a02c6b855', '5e08482bc24b', '87f66ed9b864', '5fc8e9a3cd82', 'b13a58907698', '14de94bc76d6', 'f0570bf48468', 'bb2526f50e63', '8b80afc0ccb4', 'f5d8dbbb76ea', 'fafe2eca5143', '86e407933c06', 'd75b560ccf85', '5edc226bc1bd', '114599aa1e3a', '91e528ddb026', 'bdb161895b11', 'cceaef3fe088', '427d71ba91d7', '103340bed37a', '0874774e7b82', '15724e24d678', 'd53365023501', 'a01f1586172b', '0266030bad5e', '43d5f49a3b9f', '563453ca5b7d', '5abbdd85793a', 'eeeb91263b80', 'df5c5e2ff720', '7a2f3912923f', 'af139d5328a4', '1e3f6a4ac396', '230460801ed6', 'e7be65c22a5a', 'fb3771c0cec1', '84a920088584', 'e047d710823d', '1dcaead21409', '71418d774a66', '91f62d5d0142', 'c13a141697da', '805da8cce8c0', '938cf654ca53', 'e1f6c3b3f9fb', 'c892006ac870', '125fdf219ed2', '1e2adb883f94', 'e1f467b1467c', '75224e5f8f34', 'd9fc75295910', '347d7e4a78b6', 'baf77a68513d', '4b2a66af5396', '7dbe125efe6c', '15570a1466e4', '5eaf7febe185', '85cd9d8b484f', '2d200fc33f8f', 'dab9b33d547c', 'd10fd55b3c8f', 'e492d40f5ba9', '99d9aaa32f8b', 'aed762a6b6d1', 'e42547b67787', 'a1d9c9a5f718', 'a6660f7f6d06', '1cd5bdbd68e1', 'c07b4e509af4', '1fe348dc5f03', 'bf2fda73dbc0', '9799b9378ca4', '75890284020c', 'b221d4f64c02', '772975ec5e7e', '6142bb6fa2e9', '47ea9a9c7bad', '2fa464e90bc7', '8811deec1b42', '695dc588d0a6', 'c6292ade4765', '4ca7d0cbede0', '9ba1e5dfd595', '612de68f7c71', 'cd4fc8fa3bcb', 'ed62769e8e1c', '2cda37d58330', '7f9d1ba02391', '1cdc5f91b8b3', 'b72973964078', 'f9d41e8dafd7', 'b0361eea672f', '231db832d842', 'e74f4d70ffdb', '86767179cf2f', '866b447b0b66', 'c8b860573d1f', 'c0b419daeac9', 'b3c3e05db67c', 'e0e26ab02c45', 'cad3b2dadbe1', '4ccd12a77e31', '09ab508d5263', '539b65d44a19', '91cfe37e5c5e', '8a59e6a6a8b6', '583dc528ec57', '59b0178c3df2', 'a5e4dfbc1964', '69cd851a839d', 'e17060d7a3ac', '1dcc5603fb94', 'd1784efc6d78', '0a5fd768ff58', '6188bfaec977', 'cb2e31474e40', '46e6e3e1b41e', '0b1ca4a16c4d', 'ca43ade73d73', '67517a006353', 'f3f4221c2815', '787a17d4e75f', '10b4bf3e7d65', '14932042b468', '2684938365aa', '13be1abe49e4', '33d907e8ad45', '1756e4069853', 'c6992ef2128a', '7df6cc6bfa86', '9799a7f86656', 'bf50f5f85c7d', 'b9ab2e085ea5', '075f6c3efbab', '1af702244b56', '0ae897d9582b', 'f506f6d9a16f', 'bba1bc7d20c4', '49a7ea32e431', '5b2262336e2c', '0a1e7917cdb8', 'd289029e5dc1', '860f02cd173f', '0ea5aa80a211', '5a3646ddd918', 'b958dcd6e0d1', '0b7ecb0b0f53', '20be27716605', 'ae7a5fd4001b', 'f5f40f742295', '448d75d45f4e', '4a8a0935c054', '675a445ae7db', '80cad0a96e9c', '7a2a7105770f', 'd4da75bd3da8', 'dd0b90def026', '649134351a70', '3277bf026f1f', 'b1fcc4f4cbe9', '7d96460b9a4e', 'a677969ceeea', '995bdb762a82', '8a313cbc817a', '441447dad2cc', '5791ac06fae1', '1674b485549b', 'c440579d86e1', '07ee5e3246d8', 'd85ec48e14d3', 'f3d689eb3229', '3bb9bf322735', 'c0fc8a699f39', '7915ce7e324a', 'f533f84f5591', '62110134dd6e', 'd0a28017d449', 'cbdaa0dacb48', 'd1b7a0a4fa43', '39bfa985942d', 'e874bd359eb9', '9c30b7c579a8', 'e89f1c558c22', 'a348e548ff3e', 'e7c5527c1936', 'a1aa1b90da1c', '3fc7d658717e', 'fead2876b25f', 'b6c326398a6c', '29faae39599e', 'd33b72e67363', '3f182cfeee97', '381d0cf80a7c', 'c4e30d6ed93c', '7ad2e8a64a6c', '3550151d0769', '2a67960b6055', '24161b852e93', '9f2c8842874b', '9b7adf4edcad', 'adcb4e10ca33', 'a3ad6454db85', 'bca4bb6ca349', 'b066314716d5', 'd7765428c4a3', '517fdc48f3d9', 'ece5fdbb6f84', 'fecbb8ab6495', 'feb45e57dbe9', '8fd70982b143', 'a8507315a34b', 'c8985aaafe77', 'aef96adde2ee', '36a7e9afe48a', 'ea5323043390', 'de42789ab499', 'd3788cf52541', '659f33263947', 'fd40e1bfd16e', 'b4d45eeee2fb', '19d3a81bc14f', '72a6e80b13e2', '00159b756b47', '395645cd43a3', 'a0e3513e5f65', '072d6ffed536', '095399075c12', '64b3fcbc496d', '4fdacf55c15f', '3fcdbecea96f', '7d74ddf7eb6f', '2cfb9d6f5b78', 'd1214b905f76', 'ed275a02876e', '9b371d5592b3', '59fb2e4c75aa', '9079f58edf49', '4c3fb0c50066', '7ed0b387b75c', '0f6cfbcc160b', '95c2c675c73c', 'b3c30b80c92a', 'e67cf2492090', '6656aae4efba', 'd4d7c110a169', '2f2b8cdab933', 'bece746dcee3', '868e8cf221e3', 'e0ade601f4a4', '75c1f76310f6', '39487035009e', '5fb697d06efc', '3c6f749e1e76', 'd8930affc08c', '65ccb8ee1fb9', '094ce922844a', 'affcc98d5dce', 'efb3ecd912fc', '37064c0284cc', '40eb82a64522', 'bdde4bf998b9', 'c71a007cb8c4', '4581842a1c48', '443535e689ec', '099fd3b6a216', 'ffb0e9c0391c', 'eb293f40be84', 'c542696d555e', '6bfbafeceb43', 'caace542be57', 'd5d602fdb335', '8c3df61f7859', '1e169c420154', '605c88bba412', '93018c93ad1b', 'd1a1aac23a11', '4090b207060a', 'dc1e4eae07eb', '3e9743a847d5', 'ae984c36c8f6', '31f6adb3191b', '3e344e946c82', '9f83cc822eaa', 'a0e8417418bb', 'c82a08765799', '8569a9de502a', '56545bc4d7aa', '6534ae8d5718', '79c4d56f450c', '767f6b0ac607', 'da3c8b0c3ed5', '1a32a9784094', 'be7bd527543b', '79c36b4323c3', 'b64c86c604a0', 'f0f5c83c52b9', 'f220279b2bb4', '3ef4533b141e', 'cf7b548366ef', '7cd8835764a5', '47c9218d142b', '6b432da8e056', 'c59480a85526', '5b7faf087d16', '30aa161cdb4e', '4bfdb58cd908', '09ef3226a91e', '308b522d89d6', '69d63bd42fd8', 'd61f914db993', 'a2fdcbd9156a', '87dcbc01b45d', '4a777c5c4f29', '9965fffc817a', '54d5aafe690d', '6c97388eb9a7', 'd5873f7e030a', 'be1d42ce4649', '3cf267a7ef29', '2ce616fc1dd6', 'abc7ddd7cddd', '4133729a09f8', '50e63b15047e', 'ca9fdb8c7ce5', '0e170e31e344', 'f383de32ba91', '21e68f02df63', 'e0c62bcc99ec', '540407e16d98', '5a7a6aaccf22', '1112b9c7f410', '8e8294b26438', '2436c4bfb4f1', '2fee6536647f', '0a2d1335a4d0', 'f8ab79b8b474', 'a0be1da6f934', '63a3a6e307fe', 'f3939f2ad135', '6bef368b0750', '660e9af75dad', '0f26388cf022', 'd4644f960ed9', '78ffff8044bf', 'e32752715131', 'b9c9efa7bce6', '97cef23345d7', 'b4dac06475d0', '7d5cf8fcf453', '0b4e1b25574c', '8eb5851a7395', 'a27ff9576275', 'f78933b435f1', 'e1465708f955', 'b295695a273f', '0ef17ba87a78', '6e0099e4854d', 'b48bc140a758', '9a2bbd5bd560', '4252397ad283', '1662f7e4243a', 'befe32c049ce', '75c1849224a6', 'd8503c4483bc', '3c242ac67f0f', '0627fc2dfb1d', '7f6de1843778', '73688b8b24f7', 'fd79896d47ab', '232e2a8dc4ce', '232b34102b48', '723c31c3ed3b', '51aef16bb8d9', '48fd6ee843bd', 'c7f6f6f62081', '7123e0ca2113', 'f0789661f873', '7ef226b0d7b6', '29b32800418e', 'c7c5b18b06d6', 'bc6252fa9926', 'd05fbaf62f94', '62ff5739f1bb', 'f5b2af981c3a', '05dea04fab35', '91dc7b2e1899', 'e310f886871a', 'f2e61ee84bb7', '7d5f9eab4323', 'd316d6b93268', '27bed6a1fd91', 'f549be021b8c', '78d4c640a2f1', 'de2e6de6ae5c', 'ccd57a37ff38', '1facf3c0ea15', 'ab5775d5d4d5', 'd0f458afcb2d', '10d5ab21cf4a', '95428ce45f42', 'd1af1b31faaa', 'f9119e01e89b', '19942ac65f39', 'c0e5dc10c867', 'b5a6f00fb1eb', 'bdecb0b44821', '19f1d93c8d8f', '70986e7a6934', 'a86a44927431', '7e3add41618e', 'c689e01d1dfb', '08dbc5a7d235', '99575b801d02', '113400d50dea', '691d21605131', 'af5c1d0af406', '61010fbbadd0', '32c8c668d009', '1d6f46de7fbd', '10d403d3d7da', '23a6360f2f9d', '1873a90f7fbb', 'e3b6713c22c5', '7109f7aa8308', 'de689315fc95', '1e6f2c3c5d3c', '5d14a6e484a2', '895ee285fc7a', 'ff6fba4f6751', 'cb3086ecd263', '06b8c31451d7', '4785638c534a', '7a2a50d77a5a', '93743ef179bd', '685ca72a7f14', 'd7546ffeea3f', 'cf5afb8273be', 'a1f4dab64193', '7a542590f8f5', 'd8bd66273ce2', '63ce930f1234', 'bb4a720439c7', 'c8c801d42ed4', '1ca1fd3355ca', '88ceddea27a3', '99243aebf7e1', '922b6d8a12c5', '39cdf4ba8669', '363138529277', 'f48234fd4ce6', '5ce9397e37fe', '7ff3d52e16d6', '5c97aa79e796', 'b2308cb80756', '863dd487babe', '07888b8e92a3', '60bbc8203c2b', 'aa9e5a2209c1', '5bdd787041cd', '0009afdfd273', '145ee2eea6b5', '1fbe6530a537', '279365d2cb2f', '2425c28d3283', 'a70511fe3c1b', '90ec5c627776', '004735693ff0', '677556f29949', '4b8d15b7e1c6', '52a8e0b47bf0', 'f5fecbf0cfd1', 'db378a1aa546', '4f7647ae3919', 'bcb5459ea040', '5df4d85460bc', '78b6a6601a69', '646314d5a2cc', '3f72865b66af', '51f137278c48', '8faf00b9e4a2', '00b4e5601dbe', '69d0f947b2a4', '25d8b3c741e7', '0ce3c9b85fe2', '7d75d3d4aafe', 'ddae36fd6f30', 'd70251bff44b', 'eb6ca9435980', 'a6ceb84f7672', '458b4945c133', '6a0732ff9f32', 'f4778736b9bf', '1289769db32e', '2a93bcf7cc3b', 'a2cf184fd1ab', '1ee99e49a191', '9f6824f631b2', 'e3d70a1f0ab9', 'f55d04bf384b', 'c3cbfcfc2aae', '2689a87e88a8', '90ec030b685a', 'baaae6129a58', '79c0603ebcc8', 'e6f69d49c138', '09bf6dacf3f3', '77f13941f28a', 'dac4c79f3224', '452c348778af', 'aa7c1781d604', 'eb12694c1a85', '7b79a257332c', 'd35b50bc9a35', '865f55a4f36e', '1dc5a4f88a86', '29046f8513ce', '87dcf3f8c1b2', '78eb06865dcc', '1d325642abab', '77c7462dbec0', '0fd3136563c6', 'b19e48bb0874', '95386e4e55c0', 'b0975e245ada', 'f7617db20913', '6400807f0ef3', 'd1fa8c83e283', 'c87d7f3fe252', '683232f5e675', 'ede510e97be9', '62b86a4d5af6', '644fc7947cf6', 'd20000b34b86', 'f73a6227c238', '71611d66ce8e', 'ee92f9f34632', '3e34884368c5', 'f8e8b660f640', '5266c8129c91', 'a563e3066571', 'c8563ce5a65d', '4f36b162a3ab', 'd1a5bf021e35', 'afefe51bf658', '7d379eaad389', 'a33a81eae67b', '2ab59da67a17', 'f050d1d4eab7', 'a4b1e747e5a4', '0fa3734ce304', '5033f9408483', '5422fe78de00', '5196596056c1', '18c25bbce57a', '20cd0582c476', 'ec2caf66f7d6', '6b2631b72e7e', '715fd742c1e6', 'e0914f0b475e', 'a6fec3c58902', '3caa983cbf46', '545344009b51', '175c8df32d1d', '0256961e0339', '88f698c2d6e2', '060d1a8638c1', '0f909bcea250', '51b8f0f0ead2', 'b7c10f9236ec', '6e98b82968d4', 'da8926936dd5', 'a064de623c0f', 'f1123b922b39', '373075739ec3', 'f74da90129e6', '62faf44bc4d8', '3e8d4c94b01a', '4be7a7b5bad2', 'a9d06d6f4682', '1d058b92d556', 'a346a4746f97', '6bc3d73e4587', 'efdfec715cae', 'f6aa96f9f8c5', 'e0236efa153f', '3c865f474181', '1cf035aacb48', '1ee03498450d', '8e7b571b2a59', 'd3fcf3461e6e', 'eefc3a550464', 'd0f5831110ed', 'ee5817e05ac9', '89142e823549', '4bf864dcc5ee', 'c9f15fa4cb80', 'f860ac96c907', '0730a561eee2', '044017859592', '7a0d97a35f1e', '833c627cbd1a', '1c1079780d95', 'f2bd0b69e24e', '5c9889447acd', 'bb26698bc9be', 'e8a9eda82fab', 'ef4696005667', '0c29413cda0d', '48add34790cc', 'f3f6a2cdc7c9', 'c08ddb919324', 'e046f4249bb6', '4b84f54465ad', 'aeb99a8b1127', 'b2350605e3f5', '910025630b32', '868986101c51', '1f82cdaff2a7', '4acaf6dcb115', '66f38c1b9277', '206ff2cb1c78', '878c000a9acb', '48ad080319e1', '1977480c9b24', '8f796161d1a4', 'e15703fcfa0a', '5f3a631f2ec2', '264d9d60c92b', '1346626eb0ee', '482af71e37de', 'd478dff18e2e', '5c77fc758fd9', 'd8982c40baac', '2bd7e6d1537d', '374acd491594', '7b6aa1b8cc02', '630be51191fd', 'bd87a1570f66', '6429b498bfa3', '41f1e4246693', '589dbdce72db', '76583d9dcf4e', 'ec32fb76ac7f', '246041ffc730', '6af8183b5879', '92714ff4579b', '717925fb0454', '0cccecd28152', '6dd22642ad05', 'c03ab55e3efb', 'eb84f7f1459b', 'a35c1b581584', '71f5bb6c9b02', 'def6183d9191', 'c7b73b46613c', '1f95f3710879', 'cc5a3bd3c5d8', 'c7896403c152', '8bde01d612b9', 'c363afc04c7a', 'cb48e3f43ba1', '47bfb7f78610', 'dcb953676465', 'bab0c4454393', '67ea912dacba', '3511f64481f9', 'f80b57d04e8a', '96d4a42bdacc', '009904bfdb9a', 'a67ab43098e7', '617470789520', '3bc9f0664a1c', '3422fa20fede', '6c05094d697b', 'b4c0058f37ff', '681da3f80327', '8cb311156027', '6d0f123ed44e', '82ef13f9ba16', '7e8ebd45c63f', '68278cb22dd7', '618ab4a4fda3', 'cce9b9390924', '250c12a176db', '092a87692b80', 'dc82d7cc31e2', '0d671a944dbf', '99ca4875991a', 'd55842833caf', 'db16648ab380', '69212358c324', 'de60d11240e9', '13f59122643e', 'f57b02361ff5', '8b51bc54a84a', 'dc65aec07ed6', '4d21edc7582b', '8f4ddc456e87', 'f39d83a84d02', 'a91db327b882', '7d1eb2b99488', 'f5e8c4919e0b', '1d2a74968712', '8e26a591c84e', '6ecfc8a2577a', 'c00afc2a509c', 'faf814466acf', 'e38e3bd812ac', '909748b60b4d', '6be3a115b8f3', '6bd8b4f8a470', '254bef298dcc', 'd4b35aacf26c', '4d5be5e4fcba', '0bb6217a30d8', '3075fd1743fc', '75a79dcdb8bf', 'f0c7833f7c8f', 'bda2381c1df1', 'ee0bf031faed', '194bd4758e68', '1c92a20f117e', '88d5c8475c60', '64e01eebc20e', 'f4f9b6fe1761', '8dbd1f9059ce', 'c37462e7ee48', '672a26cb7971', '03b845172084', '52363ffff84c', 'a6274197c70e', 'e6c6f79423dd', '018e7928988f', 'fd797f0ca0cb', '561f37d30eb9', '834130fba5a8', '6acd0befd7ac', '4bc5b9c853fb', '3ca60ce57aa2', 'a5d15de2b0d2', '714bb096988c', '74612a6d67ff', '1033a6a3d335', 'd720b36bd883', 'b57aa08d9406', '464d7091d629', '8a6ac5e7f692', '959e39f61139', '7a2ee34fe35d', '0cde063b5b79', 'b12957ed3144', 'c0207bc29a35', '1daaec6d3131', 'fbe3f135a093', 'c1d5d357487f', '1532974c8d42', 'e13ddf184a0c', '0366d1cd2752', '18dedae7ffe6', '41ef0fd5cb80', '4e9c9d66c47b', '7a62675a3b3e', '653b103e1a6a', '0bff231d7b66', 'c16daa4ac466', '2178ee622faf', '0179ed17c65f', '069c041f9460', '79fee5702987', '2ee7a4465fd6', '9480aa5c9647', 'f054a3ffd754', 'd7df1973800f', 'ac0b6feba316', 'd029d56456c1', 'bcd66fa6dec6', '40b49a04c1a8', '125ab471d53a', '90f1a636ed1d', '4df9d53f0fe4', '5ecff5237085', '13043826da4f', 'd6d001fdfec9', 'c72d83545406', '723295dac55f', 'c44135285cae', '3b6529d164df', '1e126b5ff0a5', 'abb381e76367', '56cea3cd623f', '006e09bd167f', '960ba47cd0d8', '1ee715882c21', '75a6151d4655', '8c5d2a7d4c04', '3ba333d7d303', '4023bbc6a0f2', '5d182dc1e12d', '53428d949deb', 'b3b8a7e40137', '74a77d885eca', '68b4bbbfbfd8', '3b39a5a2ae18', '152b0fdf9ee6', '5940be7e140b', '8222f33c746b', 'e138c0fcde0b', '521d0adf01c0', '0f6ce5daf28c', '77a1c6025ff5', '76aab1283ead', 'a071d88b6867', 'b5717481650d', '113df620d02e', '4d551f56e8be', '3cfebda4c125', '6683b11173ea', 'ee68af8f3032', '5af2eee313ee', '4c4409e7b2e9', 'c550c62d6c44', '08f4c00ed255', '0e06bfba85eb', '74854a268af6', 'e4913117ff3c', 'c6304f887632', '9d84f19a23f7', '8212dd8ac1ab', '482f0887a826', '949c07e921ae', '9fe2c12166e7', '25e9342310d9', '6f44b217e74f', 'a5cf5ea2066e', '4e2a1264f099', '106ca2194aa5', '368a6ff07a31', '79aff2a2194d', 'a7ca227b53fc', '5f282e5225d3', '4c02f31eb2ab', 'e52839f087e1', 'a4fef6038cd9', '92e77b557959', '3097035fc3f0', '69f4955d5676', '5df264b739a2', '852b0f0a115f', '0abf2a8e1aad', '3893dc8135bd', 'deed19084fd2', 'cace6d1e032b', '775b9225e047', '4b7d228cd080', '200abf5bc3a5', 'a3796b006f2f', '8cbc975613ea', '107b695a35f1', '07826f59a569', '527f2e6002d8', '5066ece78111', '06f37d5658e6', 'ed45c5459e59', '42f95c1ffbbd', 'fc509d20a593', '8d5a4a2e52e3', '7af4f874f373', '4f2c00556889', '8f158a9e9077', 'f253ce8aa394', '8057cfaa2056', '0b1745305216', '87236362db43', '3e903aecfcd9', 'e5a5968108d2', '27ee8ba11207', '843cefc035e2', 'fff9ac84dca4', '06a64162fe04', '681de3fd0334', '6e75296ac6e1', '0a28ceab3ce1', 'b6bd0a9f8b20', '0e1a7aacaf23', '92ffee25329a', '4813ba80bb97', '3f80e53cb926', 'c57db4509293', 'cf8dd405f452', '415af1631797', '7ec602b8eab2', 'af9add69c541', 'a1d02c0dd63b', 'da373e057ef6', '68b381195211', 'dd321a0ac747', '9be14204f08f', '46cc4f8c13c3', '277f41e0d372', 'b3dd5cbe3575', 'dc9741e8c641', '76ef8b6eade2', '0bc50edd1dc4', '3e37ae5ddad5', 'f8495ebc22a3', 'a8dd1073af10', '9f3dd73dfd5e', '63fb0d39187c', 'a5fa5c110280', '5f98adcc07e5', '7fe50fe82cf1', '8b209d8a75ee', '2977580682e7', '3dbbc3e338c6', '776294fd5552', '2d7af3c7474b', '74593cfe3905', 'd46154402f61', '2a5bf893168f', '9e7958127c92', '180cc787038b', '33387c3d8ede', '13e6bac09ce6', '93f8a4b68572', '7353105134e3', 'd55d3d3ab3cd', 'cca23e3f8890', 'dbc93d8ad809', 'b7f4a471b69e', '30f5e20192b6', '8fa3880997b0', '098b402be1db', '8678aa6b6de2', 'dcb6f4bab0ae', 'b3cb7ad35bfa', 'e1f574d746e7', '7c3d71a7c294', '3496e4a29b31', 'a9af4428d0cb', 'f6bd15089aec', 'a16d815043f9', 'bbfb3ae5a187', 'f3e162b0b4cd', 'e168fde15a10', '2c55f692a33f', '56b495666a8a', '2644398c9e43', '1998e0efa0ae', '76a4faee8bad', 'b30e0f2c93c3', 'c7a2f4fb57be', '90bc1e107e86', '09dec32a84f1', 'c58205a91ffd', '376c83c2b617', '6831782c7037', '714a59b1c0ea', 'b6f2554dd982', 'acc3facf3437', '9fa20a22f116', 'e77ab8215c91', '3cbde90bbd67', '01cc964bb5b2', 'd9a85f988e56', '97e2f32cd9c2', '919d29b517f8', '82d9533fc14f', '3b0308ee09d6', '0ced3dfb9ef5', 'b625915072d6', 'c647359ba0ad', '12bd92648f50', 'b177a5ab2f63', '179b87baaffe', 'fe7e57a04c41', '99b92dccb061', 'c6674f6f9da6', '94d733d4dc49', 'a6cd8556cc4c', '025a0308e344', '1da169bdad2e', 'f78fe939a64e', 'c362aba58a66', 'b3f502d51c7e', '1b3d67b76904', 'b6f89a71f2d5', '3db5a84a457c', 'a89a553b3773', '55f693d197b5', '21a323b962d7', '7f1e68a976c6', '5a97540ed4b0', '6820b3c75b0a', 'ce03da1e555a', 'b94769fa8190', '8902167e4b65', '870528d48248', 'a7b2277aba16', '7829c5aafb36', 'd10ab1446ff3', '3924c648b25e', 'edae642a948e', 'ed90a47441c5', '74d446568e34', '242d199822d2', '4fd74bdd455f', '5334c2733f94', '9637c33c5cbe', '063cdade1540', '72f26f2a07e5', '2edfb2be6170', '182e05862bb1', 'dc6d38a94253', '2c99224b5cf1', '7adfcd0d9f68', 'fa9ec5b3e255', 'ef6f29aa339b', 'eb1b0a8466ed', 'aeb54d1d493d', 'c90b320618dc', '19a27f51efe2', '6fe55d0bf9a4', '1ecf1028e1a8', 'd3ce95b7eaf7', '477beb4c4813', '8826ab50bb7c', '8f569d038e4d', '3f7ef20ec80d', '6e338ab8a926', '1baec2c9070d', '5584ee8e7ef4', '1a731b000e44', '6ab64a647e4e', 'acdf238ccc8a', '47ee912b3fc9', 'd0fee57cb7bb', '473f74036cf7', '4691f5b40298', '113a4d9f2d7c', '1b3cf547d263', 'e995d0811b95', '24bd2b1fc3dc', 'c8b51e96d3d3', '6358d95f8abe', 'd5e518cc1ec0', '4c4abb377e38', '9b925b55cb57', 'a69934671e73', '7760b86ad91a', '8ba424634708', '0a37f8c73adf', '133b8d1592e7', '9f2341d775fc', '997567d7902e', '53e3b6fcb290', '9df08336d264', '2e4fa0ae0ecb', '31d03603a11c', '0ab23e16452b', 'e2894162a67a', 'ccec59fd9e05', '26ebd3765d93', 'a506f7c7dddc', '78001a4162ed', '9ed143aa9f10', '160a7186793d', 'd28062c098e8', '264dc4154b25', 'cd056422f097', 'dfc6023b7e8f', '423027a2d875', '77879a15a49e', '923bb162aaf3', 'f10d5ba065a3', '24ea2ab9b851', '17c24a0a18b4', 'c249de06e026', '766362b56b61', '6d0ff1ed3b11', '09c3a906f293', '6450d803c688', '2ba7f85ab8f7', '7867b3053cd2', 'ab0dbf43e2ff', '7e771c37e221', '570b027e803e', '485682246cfe', '1f3d88b14191', '35a17ecbf295', '9edea2ef6f44', 'b59207fd0fca', '8a68e04cedeb', 'f967ed31dfb5', '471626fa2841', '547c9679d290', '47e79903b599', 'ec4efc439676', '0368918742d2', 'a726abcad3d7', '03c9a97ea064', 'f12afd6fff81', '52a3b4ba0100', '1bf26dda18ea', '1bbfaa5ec650', '77932fb02b43', '31775c86523f', 'e7273e636fa4', 'ea87e1e538aa', '36928ff372bf', '6c2434a52a97', '6c502e8c3822', 'aba350abb6fb', 'fec606bdb9ac', 'af154399ad76', '6d5d37acc534', '3e11bea53558', '43f15a454cac', '28fe008e48d0', 'd4706e2f9be8', 'b4c221be4c63', 'aea963311106', 'b78546b21bdf', 'dd84807788f6', '3076fd618f08', '5e68d0e6f088', '0b71ebe9b90f', 'd14e866c8914', 'd3527612d4a1', 'd6903bc7a724', '2b57807de62a', '04089177edf8', 'bd314eb01499', 'c0f7dc399046', '9c7cd9c792e3', '8b7a35326ba6', '00389a856c0b', 'b9c901737e9b', '6d00e8425df2', '7bf028bedf54', 'e0560c767141', '70faf7d55396', 'ea98c7ad7fa3', '7db4c177cdf6', '0212f8a37760', '498dda51f86d', '0ff86fb3885d', '30711a5b3819', 'f979e35ea0ab', '1a1502914474', '3b5c44877f0c', '714f7f7428eb', '8d0a29c36e5a', '29b6a9571f35', '0f17a548a3df', '5a9fd056435a', '0618aae942fa', '1549987dba3a', 'c4693cd09b89', '9afd5a2f33a8', '797792218015', '799519c897b5', '6432637b9d0b', '63f8cfa38370', 'd28c8379a69c', 'a41744835897', '38bb19a57939', '276bfb8b2821', '59f5e488e09a', 'f019f4229163', 'ab3068fc15de', 'f6204e8d2349', 'd752b4654d12', '372bee621a05', '026f775e601c', '9d7fe2e0035d', 'd026e862d273', 'b11d8ecbc8d9', '41fb1b375d2b', '60dc22c12a95', '7bf129b83bb2', 'b37e03627649', '72a51d0d0808', '437525461208', '04a82d36edb3', '422f43b22e99', '802bf69c0b18', '76360947e802', 'f2ba6679448e', '3ea050a6e4c8', 'b668312eb35d', '70367c8bc942', '655401f81629', 'a7a834891ba5', 'e61db585ff66', 'd183ddb7a636', 'b979a7771e55', '9825059e7a5f', '410cda37fbba', 'debcf6806793', '4b10625fd2b3', 'e4082d6b867b', '6229157770a4', '53ddb770c6df', '17ab1b3bec51', 'f7ad8c387cbb', 'eee0cc473c26', 'bde87178a9a3', '34b805153094', '1c9e438ae7f6', 'a26ab4e91be7', '0e2ac6f7f7c6', 'e0aa47824f9c', 'cbba6cff2916', '4aac9d706b99', 'a052cc50c451', 'ed6136ebb0b8', '6dc8dd00897c', '82d06915bfd9', '61116fcb10a7', '067cb53da989', '69135cd5d313', 'e2eb60f01ddc', '71f42ed3efae', 'd8fc155d27ce', 'd5cbd3761af2', '0867ee74c339', 'b7c409607dcd', '8a160188a42d', '1f4b2d38e5d4', 'ce5eb9ac721f', 'b699ef55a6ad', '70baa51daed0', '468d52924d1e', '5103ceef623a', 'fea87acf7589', '6ac444118ee0', 'afe09405ed4b', '8f7ebad3a87b', '17b00857dfdf', '6ba3f5048b02', 'f2c871f3e87f', 'e489cea702fa', '6ed20a27bafe', '16ed0d299e59', '03c9bccdafad', 'bbca420fb855', '97ff122411e5', '4a1b0fdaa480', '1f5116e233bc', 'e8fee3ae54dd', 'd0c56a4ec2bb', '5bf1751105d5', '360c979a8e40', '22272a96b484', '3fd93e1cc3e6', 'eeb730a057e6', 'c97af0ac188f', '5c72bd054763', '05fde726ad2d', 'ccad5dc0a929', '5e90b772110d', '2475255f802c', '1aeba14e93ba', 'fe3be9071047', '72d689a38795', '7d4b3c89f477', '5d93c5bfe328', '38009c228779', '086f5ed72718', 'e2207ee5a293', '11085f62ea25', '78a74cd07784', '8aba2bcf005d', 'fef0464ca60a', 'b7a3e906535e', '0957fffe9a5d', '4692c98c788d', 'a2bc97819819', 'd31e5d1c6827', 'ca24298f7164', '2017c488a289', '3233fc91e575', 'c69649650c84', '4be8e13e6f6c', '4ada51fe0254', '5973425a4e5a', 'f819e3c900d1', '910ffb621cb3', 'ed09435d8a55', '4b71140b933e', '76131692d6e5', '72b9e4e6e955', 'dae49ef49445', '8472daee7545', '1de4ed2947ff', 'a492f04b9c08', 'd4ae7e89f169', 'ce72e3dc5d54', 'd36a3203f64a', '6c4d5a6e499f', 'e8314f430a22', 'c61e7f953425', 'c3e1c70b864f', 'c6070bf89ede', '60eb72e8d153', '8b1076cde541', 'cae47d4bfca5', '96d648181d84', '3ce9c89009fe', '0646cf9dbec3', 'd4c04d65beb8', 'fcbc079d0167', '0905682d9774', 'db12bcbf89e8', '6bd84dc2313b', '891b7ce4c956', '1dcc1c624517', 'f469f56814da', '5f4aa41c9325', 'f2665edf4fef', 'cb2988f7387d', '8f657a64b17d', 'e6fb28b56210', '30ec7365cd60', '152f0a707981', '5761a6b4a81e', '77b6d6b95c12', 'a9693792cf00', '17946f05f19f', 'a30a32ef95da', 'f5b43b4a55ed', '3bdc6b3bc93c', '65328b49c6fc', 'c7a1d33127df', 'c601c1d1d368', '1e6ca785c7c7', '65f06d1a535f', '05086cd75a7c', '7325ad016988', 'dda14d74f5a1', 'f33a9ce87f57', '1bb1310deec0', 'b1ca6e48a201', '961484e1bdd9', '283326753d26', '70a300d717be', '808523ee75ba', '5964a238428f', '0d39539971f8', '800ebd8f285d', 'e1605517618c', 'e691aa1a0846', '28b100b5995e', '71b005a9a569', '2a6b85b4424f', '7960b56ce927', '172305d475e1', 'c990dad29537', '02066b15c83d', 'ae3458b2cc31', '5fc008b6fce8', 'ca6bd854084d', '7d715b03e9f1', 'e62b8c001cb7', '99b701f2c992', 'f7726fe80331', '55e55e53acf0', '506a98be5e7f', 'c0f9881c9e3f', '0201de160942', 'a61a22ab7c80', 'c58857f50ed3', 'fa2c182c9ec8', 'a83bb3e1a8ab', '62e3081eb5b6', 'f75ba8f37b90', '0f8279013abc', 'ee2ee76937fe', 'dca3855addd4', '70f5429935d9', '82c3bcec14d0', '8aa43ab48970', 'bea638f412ba', '94565a48bf6c', '5607638d8a56', 'e0a39c34f318', 'b03dc2c436f6', '70c49e714424', 'b93010e42f1b', 'ffe9903890ed', '70bcf6ab39fe', '4a9cfe86fd6f', '0d668389095f', 'd4dc3821018a', 'f65c8ad77c51', '92f87a93c6d9', '79b682ee95d4', 'f7e4a833b0b5', '1c09f89b646f', '0da18597ca14', '33b36b8bc1dc', 'd2076443449d', '24d4002258ac', '774917e1fe44', 'ca8f4fb025df', 'dcec46b9f6c5', '49e0ba838131', '6401c7b03103', 'eefd8e0f9c39', '35779a9abc5e', 'ca8ad4549be6', 'ee3b63357bf8', '9457a66431be', '434f43ecf99d', '413ac06779d6', '5fff35c002f9', 'f3fd2a369206', '1e65e1452ccb', '156ccf44313a', '2759ac3fb668', 'cfd977a561e5', '170298d9f23b', 'fa44f49fd7c9', 'e408c689add2', '0085fe29bbf1', 'd730a1e27ce3', '7ae00f5711dd', '433d11c63336', 'c8676837cf55', '21d185e5658e', '00ab1fb95f66', '75970f09c115', '46a4c68c78fe', '8736a9b52b61', 'aa76913cbc6c', '7e67a54a4fa6', 'c7ed176637c6', 'd852519c6e64', '5791c6e8ae5d', 'b2eea283cd37', '1037405bebc1', '02628a015c18', 'd748506cf3da', '3af965386899', '9aebfbb461da', 'aac5d49da372', '179dd1b01205', 'b4ae9c2969f9', '27b4ff8dcffb', '5ce83310a436', '0061ba2ad8ff', 'f11729b431ec', 'cfa34997037b', '1dd5c5ea172c', '58b11b419e3d', '3dd8b801102e', '7f032b6785ab', 'ddb20237214f', 'c1a63f1671dc', '7698ad9340b3', '2fe45d5597a2', '7224e8e683e0', '6fd2bece2c12', '36c3a01fc4ba', '83e5d70c70cb', 'af680e1f3cbc', 'a69fb3484a62', '4617fc7c4c69', 'be7b696142d8', '87b4ed03d932', '154b25b4e2be', '871ade84abf0', 'd290b312b841', 'a7d8a70a72c4', '592a91b83e04', '6363384d78c4', 'f013af9362c5', '2ec0d7b5f1a1', 'b9f7b37e8849', '01f819515e05', '587430b8e2fc', '115cf17d14d7', '15f6415465dd', '6c77d4a4e6c2', '402d6d70c6a9', '0ab2fcac2427', '1b8039adb7c8', '74ee26719298', '0da90acced81', '964747f9673b', 'e3a68cbff530', 'c14de7f6c371', 'de5dec7ad36f', 'ad288287640c', '44ecac5c6389', 'a8ebbd9f6acd', 'af848b882625', 'ed3feb5bb777', '1fab9068d164', 'e25bc0a177ed', '4135729da97b', '24e66777d39e', 'c7c92b5d0ec4', 'd1f500b0b756', '6e7636a6bfcd', '35b8ab2f9011', '633aa1e3d16c', '6f54ab7d7a79', '173d9a3c01e7', '93a55cf8ab19', '021c8fd4bfb5', '6b3c6574c8bf', '46a695ede1ff', 'd0538b23008a', 'ec6d351579bb', 'b9825826d3ed', '5010b927735a', '44e2f4b978c8', 'b8dfd7cc26ed', 'a140bb2a5866', '82c7dacd6901', '5366080f29d3', '450f20d89647', 'ac3a53a9b91b', 'c36af4d40e8f', 'd26160a633b2', '13186ccc28a6', '4e47e9c78ff9', '660b29c538aa', '4341924f16ae', 'ba776d77b68b', '04c79f456ef3', 'd0c02cbeaadc', 'b83b9d3bbbcd', 'd6d1328445f1', 'b978b3349681', '4283285d7253', 'c1314dba7d50', '73895771abc5', 'cb05a8c2d0ec', 'a53ff929a72a', '7df68973f927', '9b4ee1b374ea', '41b2ec31c80b', 'd909f04a9386', '5a17aa25a982', '39e07c472822', 'f62a52821859', 'e07cac181410', '85f6574f5b1c', '028ec39f2378', 'c4875782c91a', 'f075b46dc34a', 'e24e1190cc4f', '8737330f2aa1', '7d0e2be61c5f', '2f3290c1bf7e', '073f0a6550b0', '5531000e4f0f', '905b0476d7ac', 'b38a821830dc', '78a1c059fa02', 'c1f70199ecff', 'b9d5aa1db84b', 'a72cf9daf8ce', '1c09d8227b8f', '4f54e338064e', 'c5e9c6343ecf', 'af3e230613a8', '79d369b39619', 'e4f2748af1a1', '7058bd1ac737', '4a0550b36aa9', '148c7811e669', '020657f5b4cb', 'b7eec966d9e5', '45af641c3a9c', 'ca60f48af297', '21d31e6c095f', 'a3058c91a379', 'c98aa2190884', '8e91f52b6e50', 'e7c522d3a7f0', '8f7126574e5a', '519464697e08', '7ce2889a3904', '7961be71eed2', '386c7c0db39e', '70d595df4630', '697c70d12cef', '139a327fba71', '310281a1ebbe', '8dfe508956a6', '201feea71c2e', '7ffe72c713be', '48a04375bfa1', '21cbf7a285f7', '7f7bcffe5a99', 'ddf7cf88db37', '85ae98360d84', '84451b26a61a', '6739fe7c052c', 'f01672e3045f', '1bba397e2538', 'daa9c12275eb', '9d4c05dda1f6', '125815fa0abc', '98978c87b224', '193e0a70e417', 'b872689d3931', '78c1bd639646', 'aae19fd6d3a5', 'd3a02414fac0', '73968742431f', '73a93106e9a5', 'f28c6c4b7c0a', 'cd45685f0073', '81f3b70d5aa7', 'f541d3129c6d', 'd3a296233b08', 'd250850b83f8', '2c3f27bbb568', 'c0da6cd58aff', 'ea2ef52879a9', '53436b910a51', '89acbce3d33e', 'e6a58a54d8cc', 'b3d01ef6199b', '9ca8bd12593c', 'b48f5eaa040b', '395149985431', 'e659a6f996b5', '3eedb2aeda73', 'd34d459551d4', '9f482110666a', '5eb7ee92e85d', '87fbc90d1ccf', 'a7698fb1e079', 'a7f0e08acbdb', '00531272a3d8', '6e14d423357b', '474cdcc72396', 'c0c9c40a8406', '96af2cc7bc2e', 'dd58bb9a1185', 'eefbe28d1352', '52211f92e3d1', '71a6c4f68a63', 'a98196a6ed86', '9d3efce66253', '39eb6a440341', '366b3abadd18', '7fac27d30aaf', '8c241b8af46f', 'b6897c7197c9', '8432a013c752', '49e19d80b146', 'f3309e558d02', '1513216c1192', 'ab5d3c00efde', 'a2c50c9d4b5f', 'd1e5e702a533', '20d1d77093ee', 'dd1a396657c3', 'bec1be4e1b31', '01ff369180bc', '7c2d5029efd4', '1d30d4f144d6', '1fd374f8c71c', 'f467ea5f2512', '9e4115cdb02d', 'e44bc8e72d8f', 'b7f91cf7e7ce', '3eb0d5f76435', '11ff732fe445', '2b6aef43cf0b', '098dae92f195', '715f62a5259e', 'd51167b01ed7', '92dfb6854a92', '605d48ac8d90', 'c830b66ceace', '1c5cae46a54e', '1334270e00ca', '363fac9c3128', 'de7a58ac34e5', 'c0447389d41c', 'c61795145f2c', '1fd837646fb2', 'bcc15b4480b9', 'db851916812f', '4a5479450540', '0b5fcfe88355', 'eef8a41ed503', 'd821b66247b4', '59a61bc0671e', 'b0969b90074f', 'c270b242f293', '0b8083a50cca', 'd3d316c6c261', '13de6e9eefc3', '0b95f2468ac2', 'eeff6883abc3', 'd0c4e0eeef25', 'a8e5d16fb370', 'f78f8ed1a045', '1036a4e75b06', '802294b72c68', '4e15a4ad5d88', 'e3fb9a11463e', 'a6e4db111dd5', '2a8cef18fca8', 'bc4c2b342212', '4467b906ec23', '634944ad2c76', 'b649fdb2c07e', '1388466fda03', 'df6c82df7c69', '2b7f4c9602be', '0564b4e2b760', '90cca19b81b7', 'b906a6a32929', 'f99a26aab983', '061ca02e9305', '45d21a31a6d8', 'eaa79ca17329', 'eef684b949cf', '50af86ee957e', 'a46ec04e454b', 'fa40819a890d', 'bdcee021197f', '769158394b23', 'ebc59c66ca2e', '6946439aa04b', '5c47b40c94ae', '63b3178f1bc3', '0143aefa0bd4', '3f943a38f21c', '3f02e4bbc6fc', '814b48b8e65a', '6fc527ae8367', 'c085b6cf994b', 'bc33166c4363', '29f6ab5d12ca', 'fd157071447c', 'd19d0386862c', '95d7841eaa41', 'b925b34e7e9f', 'b2c3b3e59ae3', '99070021069e', '042956917cb9', 'bb0ea983d4fd', 'a4f478297e5f', '0453c879c138', 'b49498d3183b', '834c250b5e36', 'a124058a3902', '0d160f580c97', '09596ba256c4', '4f8bc70e8212', '401f681126b5', '1b733fabb452', 'a4cf16253fc9', '2bf3ffe81398', 'df81403f2bc0', '2340f000e296', '00eadef2d1c2', 'cf0286363b1b', '80011a166ef6', 'd6a5e711dc8d', '9e70bf3b288e', 'bebd34ca08f0', '0b6824a01218', 'a3b00385405c', '193c418c32db', '80da2d9c3992', '09483f155ea7', '28cb8e289011', 'b86dd154aeab', 'bb8220ecb9f9', 'cc652133f322', '0e8eb8d7f106', 'c9dada51acb6', '73941d8b222b', '82440a262786', '80c0b182fa41', 'd65940bc7061', 'aaf8bec7a2ab', 'a49c687b8d69', '91b1d16d0674', '169d2eef8c1c', '2323af703069', 'caa7806a7f6e', '2d0cc1443aec', '9f00faf1f9be', '6fec1f21db73', '30a9624662fa', '51507f2fe6fd', '9413d24013e1', 'e33722d86b1e', '5b9e90b75fba', 'c2fafc72f4fc', '73cc4fe16b8f', '5533839dd73d', 'cd731555ea40', 'fda763e3060f', '1fa5b9e86242', '1615fe2b3605', '745ba9615943', '0f5f428ff000', '72a0700e4e37', '77710bef2191', 'f64f1d65a38d', '0a2fa3373a66', '6e47468bb7b7', '0f27d787348c', '7f844d5d647f', '954e3b218d4d', '90ba8d65437e', '4543dac47438', 'db6770fa0e89', '0b210c89e7f6', 'aae292ddfbcd', '3cc404f2da4f', '31854a5eccf8', '2bc5064f56e5', 'f79b6e75fb13', 'e87b25622834', '7899c78ff3b9', '8e99249e7e38', '473ffdd5b1d6', '0555aabfe834', '38d2a1ddde5e', '4ae31a6abb90', '582e7fce69b1', '96d042cc8c9f', '30cbd48b18a5', '232f77cb2647', '92197542a34f', '7629abab764d', 'b06713ca3814', 'accca2caa3aa', '19d8624424e8', '1a5bfdc66604', '973470c3bdc7', 'e6f7d75f8a83', '457fd9d67797', '58443ce4ff07', 'a22a8ca8bb30', 'f57968f7b393', '0e5462556312', '9d75a7c10c00', '4d7baba30447', 'ee23a94b4d39', '9348a31e6411', '2772ffb82bda', '50fd32ae9280', '97d8a993574d', '35cb51314b1d', 'dfdf7bf1e438', 'cd988e4ad763', 'd298f07d489d', '2dd6f8a70c24', '351ac4a4aa38', '78f0640d0c73', 'a45f6db5856d', 'a6699e34315e', '4818f1c19ca5', '57ecc88fad34', 'e75c816bbe48', '835bf60966d5', '3a9d47a11eac', 'ee3416c941da', '2686bdfab61e', 'c754771d2c06', '39ee8d3a5f7d', '7356391f410b', '6d5151e8fc0b', '291dd872601d', '6262eb918f22', 'b40629838e01', 'eb3971f984b5', 'd1af8231a37f', '61234c3c7ee0', 'b1487c482914', '5038a2f967a9', 'c4657b9ee2c7', '97a001ba0f9d', '930314db1015', 'a7e5b4fc8915', '405b528bc712', '9760f8e54b70', 'e5768f9ea29f', '9838f8cedf48', '51adfcb266b2', 'ee1f2e05d010', 'a5e4eaec5989', 'e3e7008d7f6d', 'abc7976f48f7', '5f3a3991134c', 'fff222a91a4a', '76592453165b', 'a635927ddc2c', 'f2f6677b926b', 'af6483bdd496', '8898c76bccb3', '1910dab84efc', '2792ed6c92a1', '93f20785f06d', 'cfae0effa5cb', '1b1c681e4023', '5b8a126ddbd1', '34a481dbe03d', 'fd627efdb9c7', '0cca75213c31', '8a8587833d2d', '3bab103c39e0', 'd7837b9abf8f', 'f37bf384f361', 'e3c36c3c4466', '6e2e5def9ae2', 'f34ae3513d1c', '7dbdc7c6f31e', '3af77648741f', '6c7170bef07a', 'fe4dee809d82', 'd65ae2deb7a2', '0b86e1f00857', '008422a27a18', '0f4ddf05ad1b', 'a50fe8f3572f', '4d89fe41c925', '2fc265b85d7b', '649848d78d69', '9700f9ff00aa', 'bd2250184abf', 'b541f8476f1f', '024bf51ec0d9', 'e7da46a515d1', '9a79bfb9274e', 'b748a85391bd', '555c00f9e22e', '4b23da8d2962', '30ad12a2c369', '0f5470526ba8', '3a394a4e55a4', '4a5e10f9f7af', 'b635d3249ef4', '33b94f06bbba', '0a7e28129b73', '5d1649b5f83f', '6e3fc23a4ce5', '82cedf75caba', '701a653c59fb', '062a43f62e26', '160dd60ca97e', '983beaf2536e', 'aa9dbf91a8bb', 'ce781ec306ba', '6bc131d0740a', '47569e247b06', '2790bd1e6623', '86d4fabcf593', '0ae1f557e49c', '7862dd8ebc27', '8230fe4a0619', 'c77e47a99576', '130c27880036', '57cee455db3d', '150d6f05ae49', '49f139c249af', 'f61eeb7bcdcc', 'd15b1948ea63', 'ec60c107f89d', '1b5f2193200f', 'c49924186d44', '61da16979cd7', 'ab0e8c74d0ef', 'a6a922783e9d', 'd0a3271bd05f', 'fbf6e55936d5', '7f22a79ae61a', 'e8ba366c022f', 'd20fffd2532d', '0d56b61da3d7', 'c4e2dc7860af', '695ec04a500f', 'da0474193073', '2529d08e0dca', '61569ce30c98', 'd50bfc62d8fa', '2d01073b759f', '70e9551c7c41', 'a9be939784b4', '2dabdf78557e', '20c0bbf8fda7', 'a43fb1be00e0', 'bb82bb9d825b', 'cd30d33d773e', 'b10f4d00f7b9', '448242bc035f', '45b16b8cd110', '6ee4c63ecb45', '9e4450aa1717', 'afbd6c4fcbcc', '3a5619b515fe', '619c9cbad64d', '040a44479be5', 'd4a9db64dbaa', 'b458f5590e23', '4d6ae24c7952', 'ef4625d3728b', 'e789b2dbbb0d', '5edaaeb74bbe', '34913eecb733', '4ee5aacb8732', '64c1b590a743', 'afd591525760', 'e42331219712', 'b583a567a52f', '63c69dce7944', 'a35e0479a2ae', '83305e6da670', 'f60e12fa147c', '84cf6d76ef24', '057fec65c4e3', 'a1acc4924007', 'b9dd2340d111', '378fec70e8e0', 'c5df7cc282eb', '07aa5789727e', '5e3bea1404cb', '1b5e437cdd1d', 'd681e4392d32', '61527891936e', 'ad270652a677', '812be57f4b1b', '56bc79ad1f47', '2e9a378a5cf6', '294f4219fb8c', 'b7b196ddedc0', '18585e253dc4', 'bc93365a1291', 'c6998a06c83c', '9ccffd0b1289', 'dc60ab0f1313', 'c3a7925140ac', '479fc67fc35f', 'd45a600e3b13', 'ef5a26c964c2', 'a74fe1809cab', '26b6817a01ee', 'c4922359ff6b', '05e0bcf21f99', 'b2b4494e7671', '9987d56f939c', '83db5c5dadef', '440bf9f6dac5', 'a3c1a94c48bd', '91546b976e65', '460ef15da6d8', '03de1b78f9a1', '3767c1162b28', 'ef7ca724a32d', '3394d9964bfd', '6b460eb1e187', 'fd9b9cf821e1', '04de4130e317', '747022682967', 'ccf6df97a225', 'e7ca1e3dadce', '752dff914c11', '1bc6c047fe2f', 'a1eccc9f3328', 'eadb3617c8ff', '2d5ae58a93b2', '60c7acb11b85', 'bf750c3cc6d2', 'bc589b2dc3a6', '1da86a472c55', '6b8f083e7835', 'cc557b91c998', '3445f0a9a2cc', '1d2132fcc3c7', '56c56b6564f5', '2109015980b6', '1048ef81ffa9', '6a6428e24769', '37dd3db4199c', 'c78cfcc8b4db', 'bf91d4bfb78d', '764252e07069', 'f6d516693818', '5941196474f8', '04d31368136a', '2ab92005d2d6', 'a495db931acf', 'e7f9e05e2367', 'dcf83c6bd9f3', '6ded6937042d', 'f5909903d385', 'e9f7df07490b', 'f4ce10729079', 'dc6a95877347', '5cbee8701859', '7fa74774d03d', 'c3e367f8f1ef', '65194000331c', 'd3528751471f', 'b2e8e22f318f', 'e03a0a917314', '2dc7e4da6743', 'ccc1c595e0ed', '396d5df9020a', 'e3d63a56cd67', 'fa4d6338c0d1', '07a01c043ec2', 'd6785454c0c3', 'a2635fb1cc0c', '562e525f8183', '23914e0bdc97', 'b0929169323f', '92a67915a56d', '0da30e79635f', '2c5d0b15b880', '85a0e4f0ebe6', '9ae3f56d38e5', '3c499a3f2d9f', '1e6ab11f5b5f', 'b8e43e34ee1c', '3412f06ec685', '01ee88c46570', 'b73f828b22a1', '644a1e1e2c83', '9a4ea6a156d6', 'aa6ba4bfdda6', '522576d95f1f', 'c184e5d4141a', '9131b6577cf3', '30bfc7a30917', 'f2fb4210883f', '7ba91425f84c', '829cbb6ff525', '05bdc67c45ce', '2c688f798b8c', '38b82d5fb522', 'dea34deb3415', '248f4d953d22', '1470edcdce8e', '70631564e5a9', '06b56ac87a81', 'db3227c02ba2', 'ec0115670ca7', '7991decdd069', 'de1d92022455', '1efcd557df27', 'f0205883f003', '44c82bfdf043', '2ddffb736969', '519621d1a7f0', '2828aeeecc27', 'f998abbce891', '126318f5a20b', '3a9b80115b3d', '406da8f735a7', 'd2ebeaec38a8', 'ba65ff4cefa2', '040dab0b39eb', '73f9f41dbff0', 'ce1f98870b5f', '7747e83bc8db', '8db90c618c8e', 'be59e6327e14', '0a6cc703da1e', 'e415e5ab123c', 'e074029f499c', '6780e49855d9', 'c2d7379f56f8', '99fa9343eccd', 'faa518207f1d', 'cb4ee5559563', 'ed9c1d8558b5', 'fd1677a3f333', '45e7f421dc20', 'bf709e1badb9', '2bdf22b0ae39', '800fbe897d67', '9cbeb17c963f', 'b953f3fd3b8a', '44fcf07f76d8', '4ac79add2b05', 'd3e4a20834a8', 'fd31e4cbe474', '0132eb688d2e', '47f5116cd6a9', '60f6a8b8a304', '9c5a0e716ab4', '031be46ccb03', 'b9238750b39c', '01e95fb231bf', 'edac9ebb0cbc', 'c4332c8c37fb', '2c4d9bc4d929', 'eba391b56b70', '2c3cd4a9c7c2', '16664e1726e3', '180b1e520f9a', '85dee5636161', 'a0d47ae5f084', '1a4bc7e66804', '9a128db77fee', 'b19f1d4af8a6', 'e3c592cb0b60', '1044c0bc3e77', 'e385a24da9cc', 'e6de90d25ff5', '506f07d70543', '6ba763e8b667', 'd23f713dfcd3', 'fa2aa2459b2a', '4ade8abb22bc', 'acd9a3d2c6c5', '3541383f268a', '597037acc92b', 'edd5c7b2d237', 'd9f910517cbd', '2b94568e4013', '879a97e28d5f', 'a2e113359aef', '497bda359eea', '0cdaa7fdd4bb', '9041d626e88d', '50f0e1863055', '40210ede0d18', '755b4c4e28ec', 'cbc591fff833', '376801c597c8', '10b181dad531', 'ee73b9e137dd', '3e4df6631fa2', '9d21b0b53f77', '732af53d0269', '3d6a9c16d6cb', 'f76a8f0c7c67', '0144e0e08d8e', '8558e6300ca0', 'c4d376f0b21c', '42c59019ebe3', '4cdff54f09cb', '5177a9c1cea6', 'c1b23c335db6', '1eb876a27a3c', 'f28b7b6cfea9', 'afaca0c6616c', 'd26a26706b96', 'b1e8a832a817', 'fca0669dc40e', '263975c1a75b', 'fe668a5b6c35', 'f85ee556af3f', '4bc98cfc327f', 'a398a2bd29c3', 'c79d61b48a05', 'bfcc39407331', 'cb7c5a1c8fca', 'b2c167fc5610', '359828375e97', '09e3ccf89c0c', '5173fa3e15bc', 'd1f84f21b6b0', '2919f3ea43b4', 'da4f40795583', 'c569d67258c8', '5b8308091af5', 'da3b495951c8', '17aae08fac47', '5a3c94c69809', '8bbe048c28b5', '4092c0dfc0f2', '798fdde68a5a', 'cb437921b26b', 'ce8a52022328', '7a673073386e', 'b65de0481ef4', '79b3cf0835a9', '6c31a9d6d73e', 'a47df94cba20', 'e3c851e2a81b', 'f2cf8c33472f', '884c8be3964d', '9cf00fb834bd', '6a90caaa9c96', 'bc32f6a92001', '92c69d1615d3', '4ce368000b0b', '23cf85934710', 'c50c92b1afd2', '0ce278c7c740', 'ecb22eab3107', '655babd4f7a7', '487a1b827f3f', '15a074b4dab5', 'bf27fb1789e4', '12e3c5db1fc2', '2daa31f131aa', '77c819b3c897', 'fc4c2e0de788', 'ce8fbfded79d', '6cefa60e40d4', '87b351df0abc', '66053d601faa', 'bbf221e79bed', 'e83fa92e0fc8', 'c7c9c0d5c70d', '08de3b083c51', '7dc70f327ad3', '1774b356275c', 'f16bb76f246f', 'f9e34f7900c8', 'd1b51c0ef68e', 'e0822088bc5d', '59b788d2ba21', 'e1e80d766fee', '4f15e1b49c11', 'ef247414ffb5', 'bee637936217', '6c981c4610eb', 'b1939898de20', '246b5a7c4958', '9ad1810e5dad', '1c0c3a17da73', 'b380ade3a6a9', '0bfb9504a704', '7ad2ad696572', '9e73d3733cb2', '059e55416188', '3d4d6c5da895', 'bfe2be0eceb1', '596d36172573', 'e709f774376a', '3d42c85492a0', '7337b9150f99', '5cfe91d37a40', '41b02fe88c89', '87ba3e65932a', '83c3dd575df1', '85b92a02dc72', 'bba9a408e5ed', 'c30d9327e6dc', 'fc6078f7d296', 'a3a7b52c893b', '061d6aa993d9', '748f264cc00c', '272c8f2a1ade', 'ad58f0847acb', 'bd7443ce8719', 'fc7439112fff', '56de8a46d5b8', '83859d1599c1', '23ae7c53afc8', '39c053d3eb92', '0ea6076a5ce5', 'adae018c1b15', 'c33eba39d84e', '4e50badee329', '53d18213b492', '29aad4feeaa3', 'f22a4a08ba2e', '0c943a9a0dc1', '694dca660279', '35f26a5209cc', '9874d0faab53', '7e50c657bd2f', '85ad6cf98380', '5be04e29564f', '814cf156c735', '0c2aaf7910dc', '77155a579e1a', 'a8d3c3f469c8', 'a451f54656ad', 'c2ba3fb8f27c', '72ac980d17d5', '94720757a9da', 'c6d8a8269574', '4d9541638333', '6521781a8b80', '357d1c5cea3f', '59dff8a08f27', 'ffad1500453e', 'ca74b69f3652', 'f675752c1ff8', 'f030a6c8f4d1', '32cfbdd9d7aa', '9ae2b9c87c7d', '92150ea6bd4f', '33299e9c963b', '76eb8321b387', '51c20b9f912c', 'fc160ced3323', 'bede0f8fb3cd', '785941d065a3', 'f9af9feff067', '1a570560a4de', 'ecd33f13e376', 'a1fe1c6bf5a9', 'd45f6bc2450c', '25c109442a9a', '26ca4d7b91a4', 'd0398712ec76', 'e2dcfb88828c', '13f4230977ef', '4e6c98ef6eb8', '10988c2f3f86', '9ba67560d95d', '159370774dd8', 'de2d9322534b', 'b1d169754192', '35fce0d6feea', 'bc4b6bb0b463', '47f1d947fbdc', '8dfc87c71a76', 'a03936c0f6ea', '53d232c8a3a4', '2fee0771a98c', 'aa5fe59d0489', '34be08c36f98', 'a4482a238655', '68f1db7922bf', '182db3b87145', 'f0b99cdd993d', 'b36c12a9b8c8', 'e04ffc80c8fa', '71b9b3d26ce4', '45c3d7141d75', 'eb1c854a21da', '0427969c35b4', 'd6f80d5d2b14', 'ddae3594aba2', 'f79e370ea63f', 'cb8af3ad05de', '4fb5cb2568dc', '941a675e8795', 'c5ef0adc0dc0', '06062aebaef5', '05a9c6242154', 'ccff99a845f9', 'd7250edef049', '3919026367f5', '0027ae3b345f', '1244563468de', '0969fdb9c9b2', '33e5b15b0a2c', '8a37699f48fb', '27eb2aeacfa0', 'e2362b740bf7', 'db152aba11b9', '63ca4c0a8f30', '0ea277e4bb93', '7ca766e406e6', '88e3b500c1cc', '3b049ff62f90', '7e907740a1de', '51582b2376c0', '1b2818dbd02a', '91266eb3373f', '294c41aa9097', '6624ea28aebf', '7f1612be7fba', '3d9407f7222e', '6a07811de355', 'cd08de066144', 'd3f0e34eb73a', '40786b94d9cd', 'f82f5a30569f', '1ec077d5752c', '9caf0223c2b6', 'c6ecfdcbd716', '95faf56fa45b', '5fe2d80c15c3', '36116302cbeb', '5d85f6c0cd89', '94b3dbdd9e7a', 'e1e82267ee57', 'd8b7122c59d9', '77b3d0ce8c11', 'aad601f7244f', '6b03e36db498', '039cb079e879', 'f956e5c12bed', 'edf9d2a7c630', '4d6f31ea8075', 'cc7671038954', '994d2efe4b8f', '8eb100d195b6', 'ae3f7883815e', 'e2eecf1a7562', 'd5bbd59062d9', '5508545b83dd', 'aa9fbb24a99a', '65bfd1efbd9a', 'b995124f72ed', 'a107acae5ee3', '4e749014254a', '2b6bedef8b1c', '9782888c1420', '48cfcd439e74', 'b343ebf174ab', 'b83289ed8546', '2181ad0ac1e3', 'dd9db7cec0ce', '883dbe6fd528', '17060b2a5c05', '67cb3a19fb99', '4865453decc3', 'd7fa5437baed', '43ae76a69ed9', '8b94d8416f08', 'a33f558a5381', '24feb7b095b4', 'ede9ada2fe44', 'b6f6d42b750a', 'f77c40a171d3', 'f59d4f497027', '410812557c32', '8694a0b3dbe0', '8868148e2eb0', 'cc2fe810fc13', '1a4dfbeb68f1', '7320b82aba6b', '7f145c8a72b6', '3c3374f7b4ec', 'c699d78d9402', '310ac6dab2c4', 'c4c6b3de1a9d', '6ae3dba7e072', '831d895c3981', 'e007a3f30bde', 'e72305390ea4', '5ffd01c2b17f', '47426b69d40f', '447b4e3ad4a2', '1d1998336678', 'd1e32689b049', '9cfffb86fe55', '00668de627fd', '4e3a294ee831', '26d016d66100', '192aaad58aa7', 'af43a8e435fd', '414fbd7d323e', '32231cffff96', 'c8dbd239d89f', '52ad6e8b155a', '689c613d93c4', '1697530eae3c', '88ae2500aa90', 'b6b2332259e0', '650f369f1e61', '24ffe7a696d0', '3ddfa6f58daa', '008e163e48ca', 'af4013918450', 'a81eeca8eca4', '699d1049cbd2', '3e539893ecef', 'c6dfedb51a27', '40b0a1c57f9f', '03afa1c7edbf', 'a7bde976eca7', '4330877a4bbe', '15f3e3484e6c', '5467349403ea', '13107ce49864', 'fdea0337b9aa', 'fd9e999e2627', '249a91b1701e', '0d03d70c23f3', '1d15d78cce48', '3a0aabed7f09', '187f043954be', '62e615ada741', '002ecc57fa69', '4419b819f23b', 'ea85f71f5fcf', 'ddee994a870e', '610e996a56f5', 'b5185e757864', '1daecc68b1dd', 'ab7665b49fd6', 'f5c29819d699', '698146e15c30', '7925f9a01bea', 'febc99fdb050', '2b9765037b5d', 'e19676fc74bb', '179ae9c507b6', 'e301b9674a20', 'd7caf8450dbe', '7545a0b89ee8', 'e18c28b157e2', '12611f516c35', '07f3b969354f', 'efb0bb054e2d', '4f3700fbae8c', 'c38d64a16d51', '47d24e0ce785', '8e3d13c37cbf', '8d9f49acac1f', '487fa3c41c9e', 'd18a673a962c', '890540f31eca', '36f27208cf95', 'c9eabc36d224', 'e349455e9f3b', '463a8093daf1', '9a5433a66d46', 'dbf045781f10', '309973369536', 'f068f3dfe4e0', '77f69fb2cde4', 'bf997ad85317', '0fc8983509ab', 'fa8adb67251e', '591389a1788c', 'a8cb8fa9adf8', 'b56701da9d6d', 'd8964b48d910', 'ab3380c0cf6e', 'f42d7add0f0d', '3dc8ba9e158b', '179dcdf9301c', '4966f6cc458f', '16868719b5f1', '0c56a44d5384', '35b5bf662c7c', 'bbf9342f755e', 'd38e765e9ad1', 'b5ba19512032', '103920f63856', '94c1b35d1302', '64171aa1e5d9', '748672e986a8', 'e38cf2ff651e', '5de776178218', '7c5713a2b3b2', 'f052d8930ed5', '586cdcf033bd', 'e0b78c88e7c5', 'a227b7ff1ef1', 'bbc04c16253d', '73939652662b', 'ac5cca930382', '0b641e95c8b7', 'b489ff2baf04', '96f397f928bd', 'a9c9cad50a46', '5380712e09f1', 'e7f582555b48', '2597dacc7031', '0d5592927e94', '363c521b3b7f', '16bfb43f39b8', 'bb7b5e8e3c1c', '80eb9343c417', '88447597e63e', 'edfc0886a3b9', '7f5d3f13242c', '6617236bb36d', '581e3a2e9350', 'ec9d02e1a84b', '98be3456b5ba', '66c8c44e9323', '049e3dfdc130', 'c54c8c8a9fe1', 'dad402811c55', '33a7bc1eb7bf', '48350c52f86b', 'caf6f0556f2f', '9978cd03a300', '7e9539f62d39', '7f3f9e4596be', '54006219326d', '1f320a90c854', '1e83e872bbe8', 'f781dc9eeb99', '06e9f16a4231', '3cb31c487218', '1b550b1ffd5a', 'b6d5e29ee223', '2f6d1965fcdb', 'b9d83717e62d', 'ebab882e6126', 'f7fd826705fe', '4f554ba4a701', '463ed595baa7', 'f60f150c24a8', '9a7a501e2872', 'f324af96a1f9', 'd5cc3b4d4b41', '613c52f88ff1', '525b8bcaf092', '045c00a460ff', 'f8c2e3575f78', 'd0152b484069', '1fbf575af268', '1260ca15dba9', 'f4c3ae71b4cf', '996e72103f05', '608591956bcd', '02043fef8361', '2aa266f815a2', '3faec89aa3e5', '0cbec057df46', '783858fe7d0b', 'e3685bfa487c', 'bdfce09af7e3', '5f0445099546', '6d4e52f8d9e9', '2454228cc9ac', '8d990f7bb5a6', 'edecd1ffbac8', 'fdba06e545ef', '8873a51aa82d', '28e983a29840', '86a8484f9ca5', 'fc0f1738a9f4', '2266d805dee4', 'c521164e3469', '34b44f69a013', '059cee84ec5d', '9f1764555a62', '36e27da3af23', '6dd24f51f44b', 'aea741bc7237', '7891f66412e8', '8ffbe4c33eba', '3140dabb9203', 'df15b9dcaf59', 'b0e02111228a', '7f43da84febc', 'f522a3fcf210', '27da1078507f', '560293cf2937', '67bec777742b', '9c546650b7c8', '5553efe2b927', 'fa0a35eeb8a5', 'b15f43508f2c', '032633296079', '4a091ebc7008', '1e46330c1a9e', '3a14ecf35aac', '925be1bd66df', '5a25094d734a', '5173173fadd7', '7234c9a11dfc', '31dd216b8b6b', 'cc8eecdf4ae4', 'e5e068077f82', '266ba1c23b5e', 'dba9c5721f2d', '6e7f9b72f9e7', 'a5fcf3dc60fd', 'd566ca66f1de', '10e1da74a10b', 'c2405c64c615', 'a42e52edc25c', '465f1a502546', '291d9420a7b5', '20578c5b98ec', '36f915e661c8', '81aea0b67c99', '3e949907c96d', '07990b26c2b3', 'eb4015bcd977', '700e8bd80b08', '20b53f3d8e7b', 'be8356503f4a', 'ca6232fdb3c6', 'c87122eebd09', 'cea8b0e8a95f', '3b103a97483f', '43638990b129', '1e0016e77c63', '5a2dbab08caa', 'f3d18d7f8821', '596791f6ca8e', '4ee4b8346307', '984a6ae93701', 'ecfb950b4bde', 'ed186d26feac', '4996bbb591d7', 'acfd2251adff', 'bc0ce8604e6c', '921184f364b7', '5a5f4c231dd0', '9128154476ca', '246026ea4280', '56e2c9451574', '0c9e21ef907f', '16deebbf979c', 'fd5337878cab', 'fff4ecb00c2e', '782bd70b78b3', '374c08c8026d', '364265dafa01', '665684bb1ea3', 'b77a08644093', 'c114af8ed729', '571d7f80b6e1', '6c0526906387', '186380f02af0', '559d0f526eb4', 'd508dac81ea6', 'a32b895082f8', 'd3ed5eb3956a', '922ded6045c4', '74cdbf961fc4', '2cf8aa4eeecd', '6e217a805cc1', '6f66b753bcbe', 'e6ff37bbc632', 'd1824952de77', '581e9526453b', '0f775c5e689d', '39056365caef', '59a022c8f40f', '80233242a798', '5c40ae6cd66d', 'ee75e392e505', '94d20b9bb56b', '768618dae7c4', '73a31645dcc2', '7cdda8c488c3', '70ade09944a6', 'dcd4d48d4cd4', '4b53a809c339', 'fd03ac0818cf', '0f80b222d532', '67edadb9c309', '8e1e18bf90bf', '739214c8e112', 'a77498029b66', 'c05b5ec1e4e9', '8073219a31c8', '3776593c5d5c', 'bcc4c8d7a69d', 'be203ec68b8c', '848ba8985ed2', '4be967313663', '125e528ae6ab', '139bcea4e9f8', 'f1be943f9407', 'f11200ffaeb7', 'ebbb87f5389c', 'ee07923da77b', 'e64d977836f7', '3887b8663adb', '305a3fbb828d', '59f9753911e7', 'b7abc9cb3220', '176c0bae84da', 'ff496a439509', '1da8a333bcdc', 'acb70df432f4', 'e7c1d67cd150', 'ddd732d9e257', 'ea9d6f838efc', 'e3c07afa5736', '9ab5d012d5ad', '4d35109997c6', '772d81e80ac5', 'b1aa7cd9a3bd', '2fd63a51ec19', 'a04c00cfa4dc', 'c20a0ca6d133', '0bf7015ebaf9', 'f6e3a95e81bb', '2e7c820642b5', 'd7be28746a97', '78dad3115ea8', '65286dbb5f7e', '01de0c1c20e3', 'b8f1a6ad2503', '5def39440ee4', 'c086782cb938', 'c805327b41c1', '1da1690ef042', '1ee3856c960d', 'dec91013d6ec', '3c8165675f71', '90716ff76a71', '3829c772a09b', 'e4816328ce7a', '293f9b8180d8', '1b9d866cd6d1', 'ba11129ae96c', 'ba23defb8564', 'db6bc5bc949b', '51a98f525a5f', 'b26e34fb0122', '2b678a1b5b2d', '0e0af40c6720', '7b2e3370f569', '4faaa4e2851c', '0cd3a11964f9', '98c1990d7506', '3691f937a1ef', '186bcaba4140', '753a7670c953', 'f55386441ab7', '7bfd6c7e24fa', '0c4a871dd81a', '6ba5e975b67b', '3c6bf37115df', '9e4218d25dc0', 'e7c5a479fb4e', '090fe422b2a1', '4b1b07d8d2b8', '26e99dbc34e8', '678841e6c398', '75d772bd7748', '680d012c4f6c', '089d0f7b01b6', '886ac1b7b815', 'ff5c6d652a70', 'b15f8dc514b6', '8d985fca9bdd', '8e9f9f8fa854', '300d68c9770b', '1250bf688308', '70fe0e7d0ab1', 'c603e1b6f8ed', '81de23bdd251', 'f3c26d647c98', 'caa131b76123', '7f2979d86c75', '607d345b977d', '6b07eb478735', '22a584b01e4f', '9895b599854e', '20319aaec883', 'cfde0e0db0c2', '6348f43b3625', '93d057525122', 'ffa4b9b2392a', 'ac0e55736403', '4bcbc7f139b0', 'f48ac0a5c490', '868679ace9ef', 'abd92f72b0ca', '2bd5cd043293', '14e2a251a044', '8648d4ad7841', '3292d6592dcd', '93b9e8f73265', 'b95d2a3c21f0', 'b64f03296f57', '3ee35bd435d6', 'e36dd0584278', '7bf7d743adee', '17e9e6f0610b', '57c5f78d5cb9', 'ceed5efd3941', 'c654a36ba536', '95afc3aad796', '97f509dd78ee', '22c7186ecfc6', '372d47611a70', 'd2e5b3952c9b', 'b1082b4fb8ab', 'ebe8e82eced8', 'e6fb8f77bcf4', 'f0e9c8ce5e21', 'd702db6cdbc8', 'df61098dd903', 'e76bb47837f1', '5b50085cdb26', '1221c2b303ea', '026cc2b438b7', 'fbd67853f75e', '115f06da491c', 'a144e87b7fdf', '6f0b8445a34c', 'ce4e934faf77', '1310ae2ffb1b', 'cedadf8282bd', 'd529e19f9910', '1a69a47650a8', '264e15104ec5', 'a341e7354926', 'a3429e8c807c', '48e48451fa1d', '5713628baeba', 'a883f17f2fc9', 'bd6d62ad24e4', '13b9fa0c1991', '618542f2adfe', '366fd63bf784', 'ca94ec4c1354', 'b50c00bbeb97', '0674a25b0ce9', 'b21f3ac4b5a4', '0ab0f2709a95', '6a2896b17e47', 'c83afdccbc0e', 'bc68ee3c3cc9', '75754fae95f3', 'fd20802ddf29', '36a572bc905a', 'ec6d1bbf5393', 'd495d43873f9', 'eece92db58cd', '25747c1b017d', '76cef3c1ec34', '4909d405b11b', '270aee721b26', '71f1532a49d4', 'ab50889ff025', 'a8933fbd5c3b', 'af90abee873c', '19be3ebc0518', '560d0df3e8fc', 'c40cb5688995', '62ede169ea5f', '181861f36023', 'a193f1fb2a0e', 'f8d2df0e9190', 'a53741c36035', '1ed65900041c', '56adeba05b5d', '23cde68ce6a4', '64f2bba5582d', 'e984089c51ac', 'a2040c28f714', '22d8e97d5f80', '23fe930cd279', '37b3a0d1826f', '20802ad6601e', '1a1cff894751', '4ccc18bfb0fa', 'a9e1335695b1', '989698008f6d', 'acd355fb1ca0', 'ab3c173f0d54', 'a34a0f8047cd', '9c93ec7dbecf', '43e1c05f10c1', '86e02964cada', 'f92e3befd8c8', 'a0a3a547c876', '2cb818528a60', 'c052ec6cf140', '78afefc4a0c1', '5e9a65cd5965', '739b9137c883', '3a7601b87a9e', 'a51fc4d96900', 'f1e74f7959a2', 'c9d4e9b3fa39', '8b003c08a7f2', '0d5651c68511', '91f478b6b976', '6a2fe6b0d691', 'fbb85ff9da8e', '3280026cffc8', 'c220abfc7103', '79c620635ccc', 'a27e5ef80259', 'ee5f14ad87c9', 'b6be6ed085a8', '428b1b75c5ad', '1e08d0dd2fd2', 'effabc38b623', 'f43bf412622d', '4dbe92731d9c', 'ceb8dbe16b4c', 'f03527093189', '9cdf00b88708', 'c31928fb50cd', '7412e0c3c524', 'afbe404c7ee9', 'cb19f0506b41', '966ce4caf4a2', '2237a930b5fa', 'c390023397cf', '9af5d5db636e', '3e36a73a8f80', '66ebf969aafb', '4952f021cac2', 'b020131a9143', 'e7403a957477', '3bdf196e8dfa', '2f5684d7f2ca', 'de25dd74c14b', 'c4ad0cdc0961', '9b69cd447e4c', '0932f5b742e0', '69fd5399fe1f', '35cec5bb5868', '0561ff476724', '7ff098772580', '5abd441053f5', '08d6220d9f39', '0ff05904c1a6', '69be7825bc17', '8db1e67dd606', '65a998174f1b', 'ceef60cd6ffe', '9f29c8e47218', 'bab9ab35e2ce', 'bb49478c0710', '507de3060f74', '2c043802adc3', '7fbe0acef808', '4c9272a27b68', '9ed5f997affa', '2a8d95c8e067', 'da898bfda8d4', '4fe901ae1c29', '615ec8836c41', '48a7f93f5ef2', '304bc0948ab0', '7aa532c8711b', 'f26d09d8a67f', '85bbeec55338', '82ca8fec74f8', '69823ace1b78', '1e4f96477f0a', 'b63eb6ec18f5', '21e4e6ad9a85', '0e5e48678380', '1f1909091a3b', '86cf163c4417', '6656cc74efca', '6133580986f4', 'f409b844e6a3', '3caa8c0bbecb', '8fd570342f4d', 'ab4fa5b25537', 'ff0d2ae91b54', 'bd61b7297b93', '7493ab0637e2', '77d68b4799d1', '53fc3fbdcd9d', 'b09d1dda24cf', '2d9622d422ab', '81564e0a5ff4', '7bae439423a9', 'b960f0d4ca55', '0214bb1bdf25', '8488e786a437', 'f4000aed4278', 'b6afff482d49', '47bb73b0ca61', 'c149d7e16c41', '57de80d5e6cd', '4b4bafe2c7e3', 'f633a5d2eb58', 'bdf647beab59', '9781b74c21f6', '8ea4a2906f75', '37b78861cfae', '616a29c015f9', 'c30a561a9570', '20faf2c19f4a', 'a01f143b0541', '532ea2ab51fa', 'bdc256d02a73', '7327aa928772', '9c0df420cf80', '565f8916796e', '827d93c5ffc6', '5ea288e29c23', '655848285122', 'a6019b3ce3ec', 'b9241a93af8a', '3544d9dec687', '12434624fdee', '97c149c2ddf6', 'add5b0487bd5', 'a52a75ac5745', '1ac572d20f8e', 'd66c0084acc4', 'b416b0aeb633', '9ca90d2e99ab', '968a6e097fde', '37e0f6aae6ec', 'd608c6bd4a7a', '33c8ce600ba9', '904e740a9087', '7c5c7e3f92cb', 'f8d4dd4c80c9', 'a42e95852063', '927ff226dcdc', 'f73a0dba2f94', 'c0834b6d980d', '76a50e570a47', '5dd45bd7cb74', '7ca7f8645912', '6204463d840d', 'ebc2f1bcf7c9', 'b79f4d95414b', '765c09ab9e74', 'b0fca2da33b9', '102b1d00a48c', '78ace43e896f', 'b0dc15005271', '15f094c89432', '19e90312e2d8', '19be138fdb47', '59e99857f5e3', '17c9ccde6998', '5ac8270c3308', '65370aa3cc7a', '6ee3c22195db', '22fe5ff0f330', '3606bacfec59', 'ad0e5ef09893', 'fafc793c62dd', 'b56a5230a8b6', '22600bda013d', 'fa0ba611e2e9', '3b1d12f2fd0b', '49224e6db70c', 'cacf83aac34e', '874296aac1e3', '37e33d615d7a', 'dda781bdd5d6', '0530e3d7b032', '1ca46873917f', '0f4370951725', '42c137d8b48f', 'a11a826a2c56', 'd94a8eb8c15d', '78d5f8108ef4', '88aaba768120', '3d65eaea2fb1', '91b89285e55f', 'bfb6c597015e', '7e6492b85087', '5e683ddabb44', '08b9d71ddeb7', '075a2a93272e', '49e4cd5f1628', 'b03459680a85', '43a572a047f5', '184b1998cd5c', 'e1187fc64384', '796bcf073477', '7e3327f32768', '9db9cece6afa', 'eb32a722d7e9', '632cc7b6a970', '8d3a3adb3798', '791ef22f76a4', '03fc036465bb', '4d50ac4d3b40', 'b755fa9b4342', '73c78c8123be', '6d0d9bbaac93', '023cfbbfb9bb', 'd959044d8e33', '7e7ae646c088', 'e231acbd174d', '71566780e8f0', '95ddeedded14', '46465c423cc9', '10e5535e0c2e', '90ea9f94d9e6', 'fc922bcfc91d', 'b3bdc8d82488', '492e8e90c2c1', '9e3a5332ae36', 'db7a295a76ce', '5a745140e843', 'b755369fe887', 'e7c533213081', '853a50ab1ca1', '8882106d6fb4', '637a1d91398d', '4cb54eccc83a', '046f5645fac6', 'cc5d1260f34b', '1066c87bd62d', '5fb7447cb1a5', 'b7bcf3684356', '351282205533', '582a76c2bcbd', '8d7152a93121', '53964e115ec5', '140e676417bd', '2bdbec75c48b', 'a51c568f73c7', 'e29f3a339b39', '6131f2ee8dcf', 'cf267c264695', '892369f7f78e', 'ebecda563ce4', 'cfd3ea0ca932', 'bd4a4db6e57a', '2fd4c32ccc75', 'd44a7cb2a659', 'fc731ff7b11e', 'b81874eabc5d', '0afdfc9a7f47', '14e31f7fd128', '8176060cda55', 'af456935f60d', 'd0c451c6f2a8', '246a5cceb381', '6a8d4d6f761e', '4edc6b84229f', 'f809c0942062', 'd9e3bbac9dc3', '24d8dbe70f5b', '1dd6e017e342', 'ccc36e381ea7', '72fd9a84217f', '5fc344c8ca8d', '3a369e771bb1', '393c326c48d4', '08190a3ebd17', '77344349fbf2', '0c5da9f56087', 'c5ec80383519', '48b4e4153b3c', '39702ebbe312', 'f4747212294e', 'bb593ccb8d26', 'b1676482cf16', 'c7f9666f015a', '2e5f901ffd48', '7cf246901f03', '64d8842262f8', '8b04c1cf2bc3', 'f9aa618e4add', 'ce67852347d7', 'ff731a9075ae', 'b9ab0d7fa04d', 'ed37f0b3756e', '09cca9f7753e', '46ca1f8d2bb6', '8024282f47a7', '70ef7ff25f2d', 'cf902f2d1466', 'dec33e732d3c', '9e7a6bc34606', '38401fb30e6a', '3fb85270eae1', '72c981001305', '8b9a8b0b0612', '3a4e5d4ae98e', '10b5b641b831', '31008c1cd164', '194ac26dc185', '1aa6d74e428b', '85f8ddf816a4', 'e80a397d741d', 'c4fd21eaadbc', '08ad387e029c', 'c2e18cc36d6c', '5f3bd74f780e', '2d07de6b708c', '123f7d7a2995', '9dd95e81145e', '9469399bb6a4', '65babb38a940', 'a7a4784ef88a', '35db254d0479', 'bf007cc48ee6', '9a3099dcad27', 'bf3fedf278f2', 'cd3ea41f297a', 'c8382059019a', '06f0d9b9b58b', '5eacc7b3c9c0', 'c2eac8f3f0e2', '70a848743427', '7dafa60e06de', 'c4b215c8f3cf', '0f08cabdd397', '705737f6ecbc', 'd52ec2137c2f', '017c961574ef', 'ffedbe59000b', '8599bbba15c8', '58999e3a9d5f', '1cc5638057d7', 'e6e73154ff55', '2d33bcf50c2f', '0e8d06a52b1e', 'ca695f338014', '04fc667553a7', 'ecb415e128dc', 'fbe6244d8dab', '2536369833d1', '6f41a1a0ac77', '073b6be00a13', '0f1884871e3d', '1b7f646c0033', 'f93ce5c23a3d', 'c6cb943296d8', 'bfd090b9e011', 'e0aa9e74ae92', '1d5ab54eb137', '0e683e7df7d2', '20f38039c9ad', 'b71fcf194be4', '6604b48e4cd4', '92de6fa0dae5', 'a9e75ae540d7', '3844a530c6b7', 'f2e006bbaacc', '64bee48e4651', '9d5ab99daf6d', 'ca84b0be03a3', '3643511951e4', '843c443dd60d', 'c1ad2e5855c1', '96f5b0ef41a3', '0efc904281f0', 'f90669c907c2', '5b3d10896849', 'a9839d0592ff', '8e07d33d153f', 'ec9e13750160', '6ddbe298f73d', 'c4d999ea49cb', '2873a4b86659', '6461cd187400', 'f53efe06fc94', '830b2cafac8a', '844d64d9f0ed', '0e844b8d6f37', 'ae3ea64fc94a', 'c69c12b5ee7b', '614c1c795ba5', 'd3105208c98b', '0eeef0093dee', 'a17eec5e3ef7', 'cde2b1637367', '42f3c89b6cd6', '532eb8e8f209', '9ea26ad92469', '5ba1afc8f593', '96af41ee5f3f', '501bd03ca004', '6625fab6b492', '1714d65ccbab', 'f146b65df268', '08ba9e76de30', 'b8fdb9f06ecd', '715eaa67c026', '03238419c89f', '2ba4cce7f8b7', '82364a2e67e1', 'f9d1b28a20c5', '55795af7ad39', '106ff474da57', '33b2e85642f2', '49c19f3d130c', '7078489bf51a', 'bc00a583cb2a', '30891efd1d80', '3c093fec1655', '83ad5c8b63a0', '841d9b7329f6', '7e899e3567c0', 'a685ff045989', 'c6818c35c69a', '60efdbae03f2', 'f5c372955208', 'e20bbe31e7b4', '093018e357ad', '5d78013e91dc', '65c1976739fa', 'e5c5dd718dbb', 'f1e4d305bd8c', '74ab7ba008a9', '7b71a1dde56c', '043ca393174f', '198c648f06d6', 'bf4e83ebf563', '01a9860ad338', '566a28421efa', '58dd2e5e7046', '6653155a7cee', 'f426b85af0d8', '53ed9606dc70', '71ff601458b2', 'd0d576c302ed', 'bf327b50b85b', '511d41c21a3b', '25256e74b66e', 'ecf2f6282b2c', '5be5ac5d6ea8', 'b72362a1e1d5', '72b4cdd0fbb5', '56c0c6fcedca', '87bf064c3826', '5c15279ce64f', 'cf53eecb252d', '03dd497f6432', 'd988a1a3579b', '5c861399cc3f', 'b414584e8c81', '4e09f1df7dff', 'd810cdd0e1d0', 'e0f1226eb2f1', '3127d64d3cee', '38c31ad0fe0b', 'e516ea0a99a1', '439fea8bcab7', 'a479d889c58f', '518373820c51', 'cba13e456a81', '42b8ea4fe453', 'dd8a034ec2d6', '933484377210', 'afd6e7356d2e', 'fbb73035edf6', '5da3feebc06d', '577e5a594f25', '29ebcc1943ff', '3a858d9a6faf', '2c59551592c6', '3d6462aa3ba7', 'c634b9638503', '17a6927500fa', 'bb5b8b847cdd', 'ab90c829f9b6', '98710b253039', '4ec421a2fb2d', 'fb77cd8aa5b6', '958060e6522d', '62b9ef6e5148', '8c0199e99878', 'f4f713931ec9', '5ab7199b5817', '8faab783b742', '02081365a2f9', 'ccdac3af0b93', '20b134628e02', '2465b479a9aa', 'dc96de81d37a', 'b42d458d088b', '3550bc616c9e', '0a8ecc903278', '4dc168b1bb50', '17d520e2e23f', '0f1a118d46d1', 'eda587bad470', '8d5989f9b783', 'c9eb7db57ff8', '7bcfe2262747', '77badf80d211', '09a74cb5c0d4', 'cb284ab8935b', 'f27207607e2c', 'a9e8ee155bdf', '144ce23105ac', 'a3d8d435c4f8', 'b12a9a82765f', 'ed1a735bdaa9', '0b9f9e121588', '0d93757beb2f', 'b1b9b6f6e4ac', '253696ac8f4b', '4ec599bb5f05', 'ed1dc27983b5', 'd34e4644a424', '4f210eea41f2', '6cbd6d5f00ff', '63d1e5354dad', '0a1a4445617a', '8469441b06e0', '94e71ca86bad', '81e4af4116ad', '07fceb7592f6', '441370ae94c7', 'b3166971a412', '475592b11110', '052ba6e38eef', '866ea718f13f', '5def4fc4e0e8', '56136b23b44b', '14e8c7415596', 'df9e2e947a68', '4450c3bfd911', '99feac0464e1', '9dcd7cc1c31e', '1c25fed291ab', '263bacc0c9f6', 'fbeeadcf3de4', 'ae5fe01faeb4', '2a4ba48e222e', '7bc537dd0a4c', '70866324aec6', 'd26e72c04fd2', 'c6e7161c6225', '930882d6132f', 'b3b0274d89f7', '935efdfb2a62', '9d00591d77f5', 'aebb920d4ab9', 'ec7869a2781b', '4bedc7648cf8', 'd07378aaa513', 'f8ea8d4fe50c', 'e515763080b7', '0cc51949be87', 'c3427507aa7d', '84d018bab4a4', 'f419fc09791d', '5e89cc356c44', 'ec196f8f0a32', 'dc0325d5ce66', '29170ffa738a', '97f314b8e4b3', 'a7258253b53c', '87ef84738ca4', 'fc1a20eb3659', '076a4817cadd', '96266c404892', 'a7a4195b9979', 'd173d5b9ae1c', '3797041972b0', 'f981844edf86', '88d5f61e7184', '47ad30dca968', 'ac04ca8986d4', '0d0f8bba5bb5', '727c9002ff78', '34fb6f607db1', '9b58895f60d8', 'c7300ea2702b', 'ac145a593769', 'ff4a4bee6b9d', 'f8874756a597', '9387124ee231', '5703171d9e05', 'bb7858f786f8', 'afe230227816', '51e300bbb0cd', '333ede412c2c', '06380fd5ecdf', 'ca1fe2b847f8', '73756c0ea420', '37c62c694b35', '1118b5434e37', 'b6890fa89971', '4d414e95cc1b', 'eca84c23a6c6', 'cf029e9d7517', '963050b7bcc9', '1429576e1c8d', 'aac9396d3abb', '646a0e2ff800', 'e00bbbe56e1e', '14242bfcf4ef', 'b9959e3e2dce', '15148149e0de', 'd1020c1db8f9', '0a8a2fc82c11', 'cbb809c37dce', 'c919c8d1dbb1', '4e00209280fe', 'aaddaceedf1b', '5657ca7181f1', 'f9250a85553d', '1b24aee9150a', 'a69373032d70', 'a450b8b181dc', '7196345d13b0', 'ae26eaaac623', '4ad903f48d8e', 'e1b5289fcb95', '56e8a87c9010', '9a1482e10f01', 'cdc115e661a0', '056d1afdf8b0', 'adef379dbb5e', 'c44a0a4fb5af', '97e158971379', 'af9e3013c033', '9180d9709f20', '02c27982139c', '65ed4694c646', '0f755263428e', 'd8d8dbf369e1', 'fa5a2e4c698f', '96cba67a32dc', 'df8b1f343404', '46495364fc6d', 'f8b3a749892f', '96d6e5a0ff1a', '807195af279f', 'ffc4d3505f62', '3e43bd311e2f', 'f86ad65c0c77', 'ba229e8885f5', 'c6377e88bf5c', 'c13a588bd245', '9df7f8bb0f6d', '4ad7b57f2662', '158f25c5ee6f', 'cd94313a2f52', 'dc8ac08ed2d5', '433a6b6ff536', '10bd840e3ba2', '5d8d2752d8bc', 'c414f804a889', 'ec18b9c72908', 'bf0cc72fbd57', 'df5b5a9c522f', '7bb19ea1ae74', '4ca49183d597', '6b5b4644eadb', '74cb4754e16a', '36c41d03c6ed', '3d9f31316449', '8c1822666dd0', '697593e932f9', '9fe1d390a44c', '7a7111a02631', '6bb04d179fb7', '98744c5275e7', '9f24a518e481', '0b2a1a7b82e1', '24c0a4892e0b', 'efb2f92f9677', 'dc1eeb0a3938', '209b61f0228a', 'abcf35d3c489', 'c02371ff7611', '8a60a1d04e46', '282f83aadba4', 'b7428eed589d', '619f5b728e77', '55b383fdf2d1', 'a2acd2511f4a', 'a2b4e4da5791', '5aace45adc72', '53b966662436', '149dbb0b50e6', '3bc8ec0b1c50', '9d9c5945f82e', '136e94095044', '59c6d570483f', '84d8c0c2f773', '2123dcaebb4e', 'fae46cb14da8', '0efb56cc834e', 'fdf9ed15102f', '0a8d7cea4f13', 'c49078b0ccf6', 'f80b7abbb692', '955786a232d1', '9fe96947279a', 'a0c3faba078c', '4cadfa6e655e', 'ac2024755ab2', '42af5fad721a', 'c9cf20b3acb9', '9ac723cb965d', 'c0fcc201f222', '51f7cfb7117d', 'e4d75b46bf23', '6384f90e0e65', '47d75241983a', '09e0886164f5', 'c7a8cedde3ab', '7323c9cbd172', 'bd26a802efe4', '47349dc8944d', 'b2e769adda66', '8502a87101ca', 'b8932b24bdde', 'c57c0e4a71e5', 'dea74890982d', 'dae64327eeb5', 'cd2ba2c9f26c', 'a3fddc9c9a41', '6166cc2e8dd6', 'c8a752598337', 'a0429c087def', '6508670ac25e', '807854e45328', 'ea04ed049e80', '7a6ab826163e', 'abad50b6e6f1', 'f22e37b671cc', 'e1901033c5be', 'ea63f014c4e3', '4f70a0ac688a', '8a1d54e20674', '3c0b96411423', 'fd458d173dd7', '000ddf2779d3', 'ccd5faaaad54', '52552443dacd', '645009ac6849', '8d9cb45fadc2', 'd0337f17fa68', '6f7906e802b3', '1c38354cc0f3', '7581f9839584', '24bc10f38c9e', '27e46d758545', '2ada0a698fea', 'a000c0c2af9d', '6599c6317eaf', 'e5f08f2e3707', 'e4959d5b10b9', '897dfd95a517', '3310f7b468b1', '72e30764dd3c', 'bf8ed0e285a8', '3e56ff95eadf', 'd6100f245ae1', '592cef858988', 'c64a6361c414', '199d03fafd28', '8d72cc6b964d', '78edd2756919', '1dd6c17964df', 'efae11b45f70', '302cd93b2b2d', '95bb5edb4e3b', 'dbcd46ebf2fa', 'c1c90fba9c4c', 'a6f03210ebaa', '26413a374f6b', '25214e276943', '4fc832a54354', 'b95052170818', '3c7a1901939e', '4fafa4a32271', 'bab9781fc71e', '01fab8780bf6', 'c38d092d4b28', '110ff787d180', '83c67c280384', '9e7bcb436aa9', 'f42f98f42440', '13b0d5a73a84', '44a334d4a170', '0d09695eb356', '4cfb6d2d38f6', '49d42824f568', '7c9db38cb2b2', 'fc76d7881749', '38fefb361b93', 'fb76d9c08830', '07bee010e14a', 'd9579e78ad2a', 'f1f92c551f6e', '1b77640429d1', '7d9af386af3e', 'f79faed4b5ac', 'b7e7697e9a5f', '4c09ad80bd96', 'fb8bb72d207a', 'd028e6ddfc4a', '2961deeb1c78', '9c7e7d96217d', '5ca5e2bbfe8d', '519529a954b6', '4f73e6cf7098', 'd355ab1e7f93', '0ab564581ad9', 'e4704f61a58b', '4facd7abb158', 'f7a6783c8f81', '85dbd78ffe59', 'a10c161a82d2', 'e6596706e8fc', '86f7ae7327d6', '1594fbb6c28c', '5b077ac509e1', '37bf474d9b15', 'ab86bc1c4f55', 'c69730a7c94e', '6baa694d8d73', 'd533df829860', '3233ac76b923', '5f8018537c0b', '69444d11f6ad', '67093ca652f6', 'c9aa48e7aab4', 'ad0c17864093', 'e68fc02305be', '5829c412f327', '46349cf66746', '183fb1bd588f', '3a9837e8f055', 'ce512a70ba51', '585d9ca37ff7', 'c1f3101665c4', 'a6644be92c2b', '21b4c3ea7938', '0a9ce097cd96', '9b745e812748', '5632958e6172', 'bb510ba7a5e2', 'f6f862cfe058', '7aa43d524dd4', '3146afc97b4e', '357dfc5faa4e', '9fb85199783a', 'ddb1bb43c63e', 'b8b73a2c09f7', '47f6a3e172fe', 'f9dfadc1c2db', 'e8c565e02f4b', 'e73d249bd027', 'd94feab8be85', 'c0283867b41a', 'acb615d8e96d', 'fce717f741fa', 'db699190e0da', '8e1089f79782', '919fc58bfe84', '5d6fcc6ade7d', 'efa060644603', '5e0ac30965ac', '15014a7a5534', 'ab1da3371dd8', '0a30194ff18e', '4f37ee0f5998', 'e6d9b1e3e17d', 'f3cd8445173a', 'ce7c565403a9', '97b4492cfb75', 'c22cd03074c1', '21a7a5ab1edd', 'c461782cd0b8', 'f222769677ba', '13d30495a2d4', 'c9f0d521c876', '94bc44890a75', 'e76fff01c3eb', '0fbbfeb91a6a', 'fc3fca6dd9d6', 'd0fe1078cf15', 'eae72436ede1', '2dd491236eb0', '2e0142318fbf', '6cbb90c8ebed', '8aea86f6940e', '8c13be736eab', 'faec2c056026', '450f39781bd5', '229a95f37564', '35a3652c2162', 'afd96f700185', '6f3aa70267e6', 'e04978536392', 'b4856dcca9cb', '8c79d0acde2e', '6ec09749bb8e', 'bb90b394da5f', '4118e0556fbf', 'baa53467e347', '9f0cf6b39cc3', '6c4f9e7542a3', 'ab9d4936716d', 'd0a32da351da', 'f3764487f4f1', '127cf7854eea', 'd64993938ff5', '7d34bc290e59', '50e71e84e51e', '03c6d608b5d2', '469dc4b183a3', 'b6259902b3e1', 'bbd26d1f2a4d', 'abbdef186089', '86d9edf7c383', '6b15150c157e', 'abf38fd4ad9b', '58e1a97cb648', 'f1e496bfc41b', '0a5ccc61604d', '5824094d649b', 'a3c4d8657be2', '262df9bc783d', '5ea6ad255ed3', 'a751d15a6d7d', 'bc71486f317a', '34cc610fe7a6', 'e7b0e827f75c', '668efdcc716e', '796e915a465d', '51dc825c1484', '85f3531b87d0', 'e668cf11b318', 'a01e16787489', '2f1297e7df93', 'dad14c5871ba', 'ee1164ddcb66', 'f5dfa845327b', 'd9ed3e0d9ed9', '60bfc659221f', '85769ba705f5', 'a1e4ba9779ae', '4fe02affdc3c', 'fe132bb94cc1', '77ea01791732', 'abcbace3d6ed', 'f6fa85763d9c', '2ca8a1536302', '5bd15df16f08', 'e827071bd664', 'bac0aa5a94a3', '339d3261edbb', '71e95fa02883', '39fa61a4e234', 'd34a35bd0f55', 'ebc7c469d0e1', '53328bb1237f', 'a65e58071539', '89401ba5548a', '91cdf3f6e839', '2f1fb452de3a', '3f5e8e1f6a82', '5c74dfb4d166', '18d6354056de', '18ec77048799', 'a673656a7bbb', 'd26ebeb40caf', 'eb3b3ab0e8de', '7c420bc688c8', 'fea0a5f0b5c0', 'b10840d2234a', '9a9fdf31501e', '91f9ab0903a1', 'b5448f5a684c', 'ab00f57c2abe', '55cb3975172f', '709a26d27633', 'e0da910cb7b3', '0e149efaf00b', 'f24c3d112dd8', '3e94533c2ddb', '358569670763', '88399126a578', '330c872b3a74', 'dd11930293a8', '65cd7f601c30', '6a1b56701ef8', 'bdc3d471339a', '3a8b02735f6a', '10faca801e20', '93bf14a951f1', 'd39296f4386c', '1bcb78e71a8c', '5970f8c3fced', 'fac0d821d23a', 'eb05e80106b3', '13658d0ac0c4', '1986c21889bf', '02942298986e', '10cdadbdb481', '4881f8e985b3', '1713b057f77b', '563ac32ba140', 'aac885f57048', '3b5a775fbe62', 'aa0b7b5e3d69', '471d7fda2efc', '8580bc9c63ea', '0261288816cd', '10ebe58976fc', 'b61acbbbcdc5', 'fb6f37b194d1', '436be7b553f5', 'dc6bf42d4153', 'd795e65b2cb6', '3afa88bb7154', '11f343b2247c', '3b651df3c822', '995803f8ecd6', 'b54b75282670', '2d7fe16df183', 'aabe282dea06', '4b09da4473d8', '86b6d1301d60', '214e1e4e4218', 'd12ee3648c05', '74922fdf589d', 'e57e126608e3', 'a4e39e48d805', '8834c4cb100b', '209ca69a0183', 'dc24cd470396', '4b2124935863', '1e2fc9e2089c', '4adde98efb1e', '2349c5ff89dd', 'f07340b15f88', '860a2be8c28a', '76f9c0144092', 'bd4326af8aef', 'dd4a83703b91', 'f7391c187485', '3a11e2285dfd', 'd4a4d36fc088', '42a68c0a7628', 'cabd41f42c32', '10af6b53a4b9', '3a0f162af085', '2886b1360194', 'a2802a26dd23', '88177ba3a917', '53c5be4a7ea7', 'dcb88201e805', '73c18beca792', '4200c642d0ef', 'f9d878881ac7', 'e4e73867ae0f', 'bbeee4490d71', '20378caa56d0', 'e15ff843ad59', '244a6996f764', '8f8183387591', 'bb19b879166a', '25e3009aa9ca', 'f468b9bee194', '1f6526d1ea5a', 'da7f13d5af8b', '5fd21a212109', '58fe872d75c8', '3a63155b3f45', 'ea1cf083c95b', '5207044311b7', '47afee5cc214', 'b21357300ac6', 'd3d4c0ff6cd2', '402037456614', '949a947ac0d0', '145af021ac51', '13616e060c46', 'eb4a2b496d5a', '09ab99bc487f', 'a261629e8e8c', '49172de2e840', '2f3b03a20eee', 'a6996bc42047', 'fcd31b93ba12', 'e59a43849d1a', 'a821bcc7617f', '7e3bdc14d3f2', 'b4773681977f', 'cf392ee61eea', 'f07ff45b6d91', 'fbe0dce77ed7', '5cba2bd48ea8', '342ad6ee1ccb', 'b7cff1303c32', 'aad6f6b9be91', '4b8c39e042c6', 'bfb90511b103', '87aac21feb60', 'a71ee61e2350', '1cc254d4f5d7', '149f1794824e', 'da04f031efae', 'cefbec0e48c0', '86ea3878b884', '8058f7252441', 'cc19b53cc91b', '323ed7da5da5', '923bab858d28', '587846cb1d25', 'a49dc3d40817', 'ef2c356b7446', '704d88672c56', 'a606a9ac06ae', '6cc8fe78c568', 'f7dea347aa5d', 'ccc19a5846ae', 'fd99097f0b14', '5833255fe0f7', '5fdbad110dc1', '6b2ee7dc9f99', '564642a60bfb', '5520abe303a3', '9d97660e0940', '0085414adc6a', '717362327945', '18d7507e643e', 'a0a177b1a2b7', 'edea98415519', '99c5d67cfb12', 'cb5cd7272aa9', '91f2fd5745c4', '40081576bc43', '9e7e5a1995bb', 'f27375518f09', 'ddff4ceeec5d', '8bbdae636cfa', '9167bde3e1c8', '22cbde46bdd0', 'df0315f9d504', '1cb784580b37', '9ac7ab3e57eb', 'd87c3f061967', '92a50a53e46f', '53af5cf68044', 'ddc2e10739a5', '2f849aaa55b3', 'b2dd1c8dc01e', '3aad60157c20', '8ae533d6351a', 'faa96ae14b98', 'a66a269ad107', '10ca21b91dfa', 'feeb4ca7ea6b', 'c35289f2b855', 'ae3968b5122e', '4bc8f5ea1f54', 'd9e1843045dd', 'ccb3e07aad3c', '393eaf46fef6', '46e2be725e40', '86a3e22b0328', 'f0ddcfe7d6f0', 'd6dbb3ec1e6c', '45c51e21c62a', '26a9bc93786d', '4aaaa56565d0', '1824774f7c7c', '4ab007dc276e', 'b10ff81c56c7', '0cd5e33aaf0e', '841ab2e9c804', '5641fc855c98', 'd5843b4c85a2', '4ef4fcc0b60e', 'd1276f310634', '1c3bc6fa98c1', 'ce2eeb71d440', '638070dffa37', 'dbcbd7057bd4', '39887038823a', 'b912984f803d', 'ecf052a0f043', 'd516d6253dd7', 'c32b6e4e2fff', '00b391e93c38', 'e5ca009d0c06', '24deba2cc04d', '32e1f540f7d7', '280688fb6fc0', '21baf729b430', 'b05f12a1e909', 'be0ff7fc4286', '44e2fdb54444', 'fc8522916e12', '4a3bbc1c18c6', '772b8d118a8d', '5e2b49605c8b', '446674bf59a6', '4a9c1fdf4ecf', '058e07957484', 'a9625fb360d6', '5fbc961fe964', '1e5e733aeea2', 'b45a1f1ee562', 'd32f68c4ed3c', '8705fa532736', '6622ce720020', '83931e6aa06a', '13d90138603c', '7d5eb5e19a11', 'a5a60a0cec17', '3f0381a772ee', '58e163131544', '49842280d8fe', '3b470cedb85e', '0eaced3b7cfa', '19b1cf8efd2c', '999a06345679', '5aa955572382', 'd53b2df29854', '03b7695413f6', '2e454f591eed', 'fd7e4544017f', '567aec5d4930', '69d9c3fb7119', '02390011910e', '8b52badf4797', '72744e6a54ff', '263d0caf7255', '5012d4e47d79', '8979a9f9c002', 'b092f5811317', '4ddacd1ee7ae', '2966cc383260', 'a0728b64f7a4', 'fa936440f5d2', '71cef89b16da', 'a284802a0f59', 'b9fd66e28eaa', '9d2374035702', '5130ae5f9105', 'd020c2f3b293', 'd837033c3a97', 'c845fa5a6b1a', 'c6b9940141f7', '180036910282', '3f44c622d7a9', '49fd2d1126ef', '3c74a5fd8406', '5c1a1530da09', 'd85efa8120e3', '4526b49fbf6f', '66c2e25ce650', 'c49d2c8999b9', '1fbcdafcf80c', '49a6040d6a4b', '712efe4d9593', '28a9ad2fbfe1', '666231a9835f', 'ddbee1473396', '90922f463f32', 'd0ef228f6357', '9c4cbbbc55ed', '1134fa905db9', '9ef22aa7fe92', '688113111d9c', 'e60d0b15563a', '1a8587f68032', '4b4db5b6f889', 'd4b6ff57447d', 'f082aca59962', '88cfefb4b314', '318add511d37', 'b98b5af8d87e', '7831de3ebae2', 'a36eab44aa1a', '3c70406ccb0a', '85fd6362c501', 'ec51eca19d9a', '349ad6dbdbb2', 'd67116660029', '3233ea1d9cfb', '8def43ed1720', '6c7d1e11e7f0', 'd6ae2eaad4c6', 'b2e99659be77', 'b72ebb77714f', 'b17e76783187', '8b5d2dc3c056', 'c7541f2fc05b', '4e12c41fd055', 'd1b557f3d7c8', 'fc93e25a9536', 'b95b36b37298', '5b0aec2e1d34', '2fbbc5b9c788', '1281ce9544b5', '69df9efee016', 'ee7b3647b6b5', '36d86ff5f42a', '712c01efa21a', 'fda3aba14e28', '14a3eafd830a', '8cbbeef69b1b', 'e11860579bb3', 'ce00394a187b', '22bc57b7abcb', '2dfb3ecc95f7', '49330d7f9260', '5f045711984e', '702c071107e4', 'bb11c37f7323', 'bba575d275b4', 'c3d7b84941cf', 'f0442205de35', '7ab95f69ab01', '894c505354dc', '4162160e6667', 'd47f16c1f93a', '722d57fba783', 'baed1c4e759e', '54191b629707', 'f24cb2cb2dfb', 'a5987addd3d1', '22d80cb803cf', '063adb9120b0', '27c890f34efd', 'e8fe30f705f0', 'f60b9f82f848', '2208945ee6b5', '2a575ff4e729', '29a75785c63d', '59fe00ab00eb', 'ca6a0af1955b', '9b52b5aabf92', '9a7f17659716', 'c711e242f69a', '78186705771d', 'de7ca63dfbe6', 'b17c1f709e5a', 'dd326885094d', '5577aa11beef', 'b698ebb6fa97', 'f08e4028091c', 'f65a182b25cc', '37e4c774e94e', '94c9760da0dd', '0d6e3614a0d3', '7cf065326b30', 'd1db25e3639f', '5b7629959288', '72602053055a', '140587fccf04', 'bf12cad8dc5e', '818525be6fe0', '183830befbe3', '3330c6e9398b', 'eb4815d3f800', 'ad24ec7cf9f1', '1843e90a600a', 'd0d8e7897476', '474f51fc2420', '7190341b128b', '67fef9ce022f', '44942bbd43ca', '7a0eb61f802a', 'd7b615385288', '974c53bd0a2b', '62f3d71b8270', 'adda7c0a91f1', '8672cdf3a4d0', '362c51520403', '7dc1af00190b', '3283ccf431c0', 'aa193e3af54d', '7e2bb05a89d7', 'a6b881003096', 'b9e754d40ee9', '597e57dc9cd4', '86b9bdcacbc7', 'f81505848065', '747a086c0157', '8f157fadc644', '56c822b7fdfc', '9bb542aa829f', '7d2eebd080b4', 'f099aa03961d', 'd737f9a07586', 'cae1c1354e6e', 'fb114e678912', '271c15afe555', 'cfb4ae9baf59', '2aaed76d13af', '2ca56fd857ef', '99bde01edac0', '5c2be060feb9', '8137ba886afd', '37f3ec1f4f74', 'b3c1b89f88b3', '8fbed9d2eb9c', 'd0b7fb9f17b7', '5ae04a80f863', '2b2007fc012f', '5ecf6a8f8b10', '502b4fba7f44', '90a40c4be0af', 'eb8246bf40d8', '2f9606fd02ab', 'a2260efd39a2', '9b72da60a846', '5b0c6cf4b2e6', '441c85db975a', '0f981aadfc74', 'da36e8b457b2', 'c4b1f988effc', 'b441ec286199', '2b62f6cf4c57', '62a1d5bdd2df', 'a95b3fbf7f6f', '9faff92ef6eb', '81e5753439d0', 'e0d655e3794c', '27f20ce39115', '55c78248b56d', 'ca22b0c37fe9', 'c7468346b0ba', '20550d6ec482', '1ee0715c4922', '75f0f85a1260', 'd293de6e97e4', 'e2eae8e0a782', '19ebadede563', 'ccd23d9c3995', '0cca0faa47ce', 'c011f073c510', '3b17800ab8b4', '5686d50ae9a6', '2561f81fb06a', 'e10a853c504d', '958cda82f41d', '7abf38fd236a', '9de2c8eb59c6', 'e646529cc8aa', 'e63f21b95bb3', 'acf7214da5ef', 'f53c3a944b6d', 'b141c76d001f', 'dc300494e640', '30ea0b2da435', '2b3739c635c2', 'fb734a160d10', '9dc8deb54def', '702b979b68a8', '87b155613a4d', 'fc6dbd250a5a', '7091bc744ebe', '9b446b60975e', '38598ec46703', 'feb733a032c4', '12a1e5c6b752', 'bd827ddded80', 'f5c829065588', 'a5b6245a597a', '770e14b06a98', '3c56a18158e1', '7ec1dc7c57be', '7f0bc475b049', '71839d12d9fd', 'cfafa524d111', '70e9a1a815a8', '2fcd8c7bb575', '9167f8b54727', 'c865e6d20718', '4dec80c999af', 'b8d9827a7bca', '996f2ea71c9a', '2cf51e344e48', '502f8625752d', 'e2d1734e1750', 'd5f563547099', '8c9eac11965d', '9c3f345e9fff', '6d29011b343c', '5c6bee850ed3', '59e2abc55099', '8f3182c6a55c', '131065c21b0e', '771e8c086694', '96f0d7cacd9b', 'bc9017a9ad55', '7d3ff934006d', '1d3ee0b3ef85', '1c13c9dda1cf', '3fa3f9d1167a', 'bcaab877cb49', 'c06b7430493e', '0d72e9b4cd50', 'a5f698e079d3', '33d6b04fdb23', 'd03e9ef16595', 'de436b4c4117', '9498210cf003', '0f9e98b42504', 'b25a1151717d', '000033934663', 'db8c66213fb0', '4c71a629501b', '99dbca7f85b0', 'dafbc6704940', '30b6958fa9ee', 'bb555504d8e5', '770c76b3d47f', '86d828f3e705', '3b2f439e1855', '4019692f4835', 'fdb2cb1705cb', 'bb8c6c59322b', '09a093659ac0', '7cbffee8dbbe', '01bcd1e2bdff', 'd37abd1681ec', 'f2fd1cbfdd22', '02cd0904685e', '860c94e66625', '6e43dc1c7539', '4a9d8094ae6a', '24714aac2705', '5e7cc525b149', '45728d4dc3d8', 'aab0199c2ff2', 'ee16049ec201', '50f15fe3428e', 'bacd7ad13491', 'ca7cfdc071df', '49ee61580932', '9b88c8956c78', '3a469db0eaa2', 'ae7a90945a0f', '873fe63adecd', 'd176a9f5a1fa', '73058c7eef03', '43f5ec9fe071', 'fbe58425b317', 'dd4b9ceaeaf1', '6aa0e580daca', 'd98ae4547edb', '12e0672edf48', '0d7972e65834', 'c2f8b5b3ccfd', '65811420be2d', '4a24e7126422', '76b43009764c', '4475e5fb7b91', 'c268b2a51ed2', 'df0987e2e84f', '6c13dfff996f', 'eace3337a0b5', '4e94af8b60a7', 'b9ec46e0fe3d', 'c4950dc8a2be', 'fb0b62a045ca', 'bf744fa716c2', '0da2f0c877ff', 'fc6d54d7e324', 'a392f9c3bfa4', '8a06cbf5e940', 'aee4a1334911', 'af4fa95104b8', '1e5038c2469b', 'fe59244a76f5', '44d608f9189f', 'eec44dc5a7a8', 'a993e63d5248', 'c1e305fb8b5b', 'a23f4f7c020d', 'c0f901b0b5c3', 'f33fadb42fea', '6cbbc445bd6b', '306280cd2573', '7a8050721656', '12b3581653e9', '39e0180af33f', '566c907a11d2', '0bdfb178c4ed', '50115f924289', '4c89575cb027', '2fe3337654e7', '1205cd12e219', '8799718028da', 'abe0ef73cad4', '217a5b7fdccf', '2242bd078973', '3fb370b8c016', '88fbfa527e61', '074dc1f0efe0', '207f24b781e9', '8a91eb03bdd0', 'd27f66dbb213', '365ef813074f', '0006f1f2dd0d', '317399f455cf', '5108a026343d', '33ae0873167a', 'a13ed4467d70', '1279403c3d80', 'a245387f5348', '179430549ca0', '431270945ac5', 'e94521ff47d1', 'f86434d15b87', '4942806bd3ef', '315c0d2350b2', 'aabdafee47e6', '1c47aa5df9da', 'cd548e7f7a2c', '26eb1eae662b', '02c08e37ea21', '4d4b97e4ceab', '19e564643bc5', '2fa525bbf9e9', 'ca8542d667b1', '93e965e2b8a9', '6ff067adf4bc', '1c6cdddbb375', '782f3d51a0bf', 'ab9a4f72e6df', '64f3c786365b', 'e9966797f1c3', '0f5b36f5c711', '55073dbd5c78', '80b0b49d087d', '80c785628840', 'd69fb0dc7ff8', 'a4d4bbd0c963', '0b87786675da', '68598975a17f', '67abfc9c4dfe', 'ae2b330f67ad', '6b5638d592f6', '042bed840c34', '47f2ee372fde', 'a037b18be501', 'e9a6443c8335', 'ee257984ee65', '2d87a7988a22', '80bdaad65ff5', 'a33bc91406c6', '44e2a3e937a0', 'df06c25c6991', '0cf837b95a39', '9e870f2de70c', 'c51339a50ea3', '332892c3e1b1', '8c0d4a7a43ef', 'aac574d2b4bf', 'ab6a02f152c1', '5b851e5b9b83', '48f84adec091', '0fe5b31d22db', 'e7fbc8f58e47', 'f34edaca5b43', '7cf15bff218e', 'bd6505557060', 'f6622df25a89', 'c394b100ad59', '5eee79ccabad', '96a184c811bd', 'c2b4810b5a96', 'aa9be8bed3bc', 'ce009570d56b', '874955c36023', '8e9392db2887', 'a7202b2f2bff', '4718ef62e0ac', 'afd622a13143', '21f2bdb30391', '7109dfa1e6d7', '7981ab715b74', 'ce5d806e80e3', '81d285ab4078', '9a1076c97a85', 'bc2d30272bf6', '84d08962c6b6', 'e636e73ba9f3', 'fd4ff7dfea53', 'c0d48fb1ed35', 'bb0327b24002', '29d1b6b67778', '0e5c19ec64fd', 'bd985cf945cd', '374326074092', '1d2de89433d5', 'bbd70f43c1e5', '14df705ba923', 'c28039b4a764', 'da7d77bfd19d', 'f68e68237cd5', '08e08b9d3fac', '27eb4d285537', '2c788342d968', '1985557fc41c', '15386a0dde7b', '40d2176faff6', '3a03de7a34be', 'cd7e118ec9e7', '097823045717', '65749699f0ce', '22ed4e735085', '32b79458932f', '5bbdf94ad15a', 'c05ca6c519ba', '96a20f381509', '20654109560b', 'df5d9229a213', 'c275035ce88f', '220432f28685', 'a3c7870a74e5', 'df9a9a8eb549', '43076621aa24', '2a7e3ff8fdfe', 'ec48054ffc44', 'a7c979160cb7', '5b44bacd4ebc', '301020abe8d1', '1f078b6f1068', 'a545740b8e69', '0971c92cee2b', 'a25322e7c718', '76c93c484a15', '18d6a8cb875d', '268cd0375597', '443035046944', '48a841783610', '4fb7b56fcdcc', 'b5607231f79a', '539f8807aba1', 'fdcc2f23321b', '0813ee3b05ad', '955d0b882e09', '155c79aac834', 'dcde68a25277', '65d5996e78b2', '2bc478c48a25', 'b6e39210531b', 'f65994f7d69a', '79d25304bcb3', 'c500efa959c7', '3826ab0ab761', '344dfba065e7', '4543896e17b8', '972c2b5baabe', 'e5e5a956da0c', 'd8aef1d6c6a1', '1c95114e1438', 'a0db1c20afca', '2abcb8c2421a', '8e6a7dfce8fb', '2f2ad72c6ce3', 'd79d869a1b2c', '41e2c0d53a81', '78598c5ebfc1', 'd088e9606315', '8d654f2336ae', '794a13d8d381', '71669851aeb1', '5efdb5830175', 'be50545ac745', 'cabeb47e0d81', '0aeab46a8ee0', '76948e9b1882', '5b00c255ad9d', '32c8696bd0ff', 'd46d78aa9579', '627b0bd3a52a', '1cb0d375c177', 'c8bdba7ff0da', '604c35b3c533', '191e81250fd1', 'cc15f8daa5c4', 'dd657cc90bfe', '1e0347628d11', '819548a7ca63', '07b4beff012a', '7d117037f68e', 'f988dd332f6d', 'cf2e47ab83c2', '7f53b2367120', '53fb4b2bef56', '062e0526bfce', '419cb989158e', 'f347343935c6', '26934305d9ed', 'ebeb30c75ec1', '190665798182', '88131795adb1', '2e803c1dba7a', '663298f54a80', 'a2450b949427', '8fee34833a6a', 'bca22e8b2901', '7ebbddcbd175', '671c29cc7b83', '975187696a99', 'ca3a2760a29f', 'b0435b17ed29', '56986a2cbb1d', '6b8ac72337e4', 'e3c01ed363e1', 'b01e11d2ab62', '333a928a8025', '5ee2a24b8cbc', 'a1b9bc29e5cc', 'ef6afc3a9b37', '04a9439deeb2', '6e332fedee93', '48c101dbcc9e', '426c70bbbbc2', '727067c8548b', '3f5ad89c70ec', '5ef0fe3b8b05', '82e9289285ad', 'd6eb1461b47c', '32f59fad1331', 'fbfbd19f76e9', '5776f0308106', 'a22789a711ad', '06448d37fa13', 'bf99260b1a65', 'bf75382496da', '01039fd07598', '4c1141450712', 'c70c4042cccd', 'b8635a00854a', 'cd7586a86d00', '9badde47edf8', '276ea7bbc467', 'd56eb0a464f9', '74307fad5024', 'fae87eaa2bc9', 'b2f53978f442', '94d3aa84f5cf', 'a46d9c60074e', 'bf20244590da', '20b86e231279', 'c2be49fa89ea', '7a9d9b8928c9', '493114e68837', 'c501657141fb', 'cb7c7fac462b', 'dce47216c76d', 'f3641ec6ed17', 'a2b3d3a554c5', '6db267c1db21', '3010ce7a9312', '275ef5374b9d', '0bef07f78366', '499f0f152b5e', '04bcda8e2f00', '12ec5aea13a0', '8746bec7278b', '8ae2e2af4844', '0dd686f1cc8a', '54f094011670', '2a0776a3bd1f', '841bb57dc08d', '5b0b2d60b920', '655986f35401', '24ea1d53e5dd', '4a1028750e8e', '8906034ce406', '97364b70df3c', '6cae7bb6a4d3', '320f31251c65', '13a28dbaef91', '1af82ae8fc5e', '1a206dbf1ca3', 'de51caea7e9d', 'ce58e0b28271', 'bf625c48e7e8', '3aee5c7a8180', '4bfa9c4c401a', '4a99826e6bab', '709ae4f0eddc', 'c574dfc56905', 'a846f9c03c1c', '1b66a7d24fb8', '19360a61319a', 'e428652443e9', '842bc265283a', '7972714950dd', '38300f8fc5af', '9210a0654509', '15fc6e7cdd92', '4a3137b7e1a9', 'a62bc2b638e6', '45266c9a60e1', '6f9ec38546c1', '75a7225bf22e', 'ed0b76366ee3', '6d215a7d3e7b', '923a5f0f6174', 'bf36a8fbd501', 'b051340c56b4', '6d2ffa1e79d8', '9b05e18825a6', 'e346f9f9bf29', '4afc4ee2da6d', 'd5c660a7aebd', 'eb0ff1d2d3b5', '8440180c097d', '7166dcc519db', '354ef4c391cb', '70d5b08ad67c', '530d34f5032a', 'b12e8d1bd82a', '79dec79d5d49', 'b8e53db65414', 'b8dc3aa3de40', '630d3d815ac2', 'a2308e9b72fd', '46ff04186f59', '965e5b708dcc', 'b0d18cbabb7f', '191e662592d6', 'e876b26de007', '8360a7b1c95e', '402058e2b793', '726d67fd6d8f', '11a66fd5116d', '79eb53162786', 'e296a61e9620', '6503dd0d8dc8', '187df80406a0', 'e76f03251fb4', 'e9282a96f395', '6e26340d2702', '56d3bddd9f19', 'be8031cc9e42', 'be83966aa596', 'c2d936ca852b', 'd175d10aafeb', 'd50e9984976d', '77d27d256d6d', 'c0ca4d33c9fd', '118fe09b3f4c', '5add6f53de8a', '88cca293a0a7', '94b69423fce9', '9d2fb3a8c02c', 'f924349aa5fa', 'd3b135975706', 'd1a67466e48f', '8d105975e847', 'd0bacfe579b4', '46229ebdb9ab', '6735aa3cb921', 'bdbe24c96e1a', 'c398d4eff4dd', '78450135b1e7', 'efbefe6e4eb6', '9a0113ef5134', 'a6d9029dfccb', '7daf5120572e', 'a546786bbe26', '238885a874af', '9e11af19ba43', 'b745d00c0f13', '599a5df8c599', 'd7da011a7c99', 'b650c1f8fe6c', 'fad3bd221baa', 'a370d19a57d4', '6181379721bc', '8d44d7f80fbc', '6e11e0657938']"
d+cN!TO]C@*Cc<CCMK9,0,"['Lock SSH directory', 'Save SSH key', 'Get CPU counts', 'change password', 'Remove security features', 'Get CPU info', 'Get memery info', 'Get where ls is', 'Get system info', 'Get crontab deamon process', ""Get logged user's activity"", 'Get system info', 'Get CPU counts', 'Get running processes', 'Get system info', 'Get system info', 'Get current username', 'Get CPU model', 'Get file system size']",988,206,300,1494,"['c9e585dd90d3', '415b5edfe1eb', 'dfdfbb436575', '3495f5690be5', '29de5056dc99', '1d24a84656b9', '2beecba14c9c', '146bde52aaf0', '1dc888934ee5', '71555a6cad82', '972f8a362c35', 'ac383a739ac6', '472aa3cc5dc3', 'c55ba48bfc8f', '6ac2e7ee121b', '17adef798848', '0522ff550835', '5a204d7634fa', '11e5591cae5e', 'e86025374897', 'a1d73478a09a', 'cdade54ce8a4', '4ef396dca36c', 'f8ac41c7d6d2', 'e3375c138c7a', '970207db21fd', 'dad44fda62ae', 'f67499369988', '0449c09d42c4', 'cbc1019a586b', '2c119333d96f', '068094bd7084', '2ea33d5f1973', '5a7fdeb54f12', '012d16d16ec1', '1af7b01dcf43', 'f300f000f7c9', 'd91d56c52539', '46347a4584f7', 'b26304d11e5d', 'f5c587f99e06', '5dc4c3363b98', 'e2f5aedd4930', 'ee1bddfa0ced', 'ea458723cf21', '1fb88cdaf8ed', '898a80818662', '103c2144178b', 'fc7223444896', '906eea5a6118', 'f9954dbd1ca4', 'b4a1fa6564c9', '7e432094eb6c', 'ea6cb4bddc5d', 'c10ec6fe73bc', '6f104cbf3215', '71750429b5fa', 'e5e138502fa2', 'cacb5ae505c5', 'fa12d788ad45', 'c066cdf99f50', '9e88abf6bf64', '8e4c974d82b2', 'cadb9fe14830', '432999e882cf', '13d59e794862', 'fc5bf44af5bd', '9342cc8432de', '0dcaf4c06d91', 'd1de04d4371d', 'e2d46c3d4933', 'dbb02e953bfc', '14fd08035b21', '64ac75261532', '9530ecc1fdc8', 'bce830ee8dbc', '48ce2c1801c7', '3e3107226ea2', 'b230123773e0', '5477bbdce4ec', '2ff9aa629851', 'fb10de83b14a', 'da9eb2972817', 'f0891421bf2d', '4bb538ddff1c', 'fd3e4f376468', 'ed9af3c7c39d', 'a640ebea7e69', '3dcd0f0755e1', '903bc9982bd6', 'b71a209b8241', '04125fdb8df6', 'd15764178376', '83e2ae63d7ee', '5a44080056f6', '878065503124', '03a64505a7f2', '6a43c2875294', 'a90b2b43c4fc', '8c795f88ca00', '9cf215c28cb8', '2be361a2f27e', '41a817189a09', 'ad993bb757e6', 'aae332afd1b2', '1f3efaf039d2', '7ab3103c46d7', 'e1ec79f97d94', '14c1d998b44c', '15bb4a1bdc1a', '8b8c05ccca92', '78e9ab894fc8', 'bf80889c4ba2', 'c43820db91ef', 'd4aa2bcd0449', '7faa10abd80e', 'ce2bfa64e016', '04bcb1cc3406', '165561f01dc9', '48f80f279037', '974e28252a33', '41ac4cd926f3', '9c21c64f7250', '3c04e0c636cb', '5c90c38b20c9', 'ebfe7c29f0c8', '8aa8ce164298', 'd295d3a8a698', '67ad1fe4ecfc', '4d414a76a719', '98a0263bf091', 'cea4fbc2886e', '59327bca814e', '67bf8500bc40', '57060c0e86eb', '1e3ebdf2ff95', '216a1133f5db', 'e1d6dca40277', 'd86c4742dd4a', '889bd7b9e54c', 'f7ac14b9ac5e', '8473c7285a02', '392ac857af53', 'aa672a2488f9', '86cc489eafc7', '3eac7212bff0', '76903766e5af', '4eb8f2d80780', '68d206244735', '2f53c0c2b7f0', 'c0dd8eb5bcf2', '7fcdd417b390', 'c3c106c864d0', 'b7f48eb1f92f', '409a1dbe0938', '6790e36efd9f', '0a32aca8ffa8', '1951459eaacd', 'cd56dd206cd2', 'cce4ce448677', '52efab6b87f7', 'b24e9f9c7e8e', 'd0915b5372b4', 'eeb2716aaf17', '2a2b762dfb54', '209b624b1740', '91c354c319ec', '699a901f5026', 'd7473e5f4236', '43fc63e0360f', '5f2f3f295cd5', '4ccbd03f6dff', '65c1a50d0cc0', '4de5e22d0797', '60ca8299cc34', '6454127efdc4', '700e924a04ff', '54486a26c102', '6e6df5198ccb', 'afd8f903be68', '5b3dc2d10a88', 'a4380ece27bc', '56f8058d3422', '3613ac2ce41c', 'fd774a21a89e', 'fa012ebf4f48', '9a4145071bff', 'd452eaf5f36a', '31cfa1f2cc16', '6c0b55161166', '936ca8e71c9c', '89fa06b300c5', 'b562acb6b207', 'bcf7e96fdd85', '49efaa65d51e', 'fea87b302d0e', 'e802f0ac03d7', '28f229a7f200', 'a65593a6552c', '4614c233f802', '6eeaeae8af6e', '6d355d3da65c', '846372e3858d', '316ea0b38d6c', '23e83eea5f4d', '7217836d38a1', '10c49503e855', 'cf0f267e28f4', '6e2bb5077e71', 'f483a022f353', '8d298dc8c2be', '5fd067360c28', '8101efc9ba81', '5952ef7b9a4e', '708b49d8d4cb', '1a383d0d1b55', '3a9be9543d1d', 'd5c280b3316c', 'c5f83035f3b1', 'e85ba879b774', '4f1cf7707c67', 'ba2b17f54479', 'f932398c3ce6', '1f2d5659abed', 'a1af48fed585', '3f7dc2d16406', 'c18205fa5fcd', 'd12ee870c917', '6141f3be7fd1', '09292d8ad168', '4f1037745aff', '76f8c7dbd756', '75220e7d0097', 'b364f1054ee8', '81982612bfea', '7c115f34c63e', 'fcf78dc7e6d9', 'e00e08cece72', '00a974bb0f12', 'fe7e15f1a8b1', '30548847216e', '7ba836953536', 'd137bbe37747', '3481e750628c', '81bd64b1e5b3', '0049f41ad88f', 'b03cf9a7615f', '5f9af44677f8', '8b34acc3dc40', '021468a5a60a', 'e96d2ccf5791', 'b2066812124b', '192ec4c4b2c1', '78779c8becda', '3a87d8f36ed2', 'f80e56982ea3', 'ac4a9608d6ed', '2c660797bf7b', '6b28d0ff19c6', '7912ef0b4b3d', '005e36f80b12', '18860ff8c94c', '196ef73d4421', '104f2a2d42e5', 'ba2a8a4c9a1c', '3d7e6f548e51', 'f0f0be351aae', '83b18a45a04c', '03ff3aa8c60c', '3345ad051698', '53477b94876a', 'f09e67423889', '8d9df24d4658', '8682c7755869', 'b563031d4a10', '4d02e0a8076b', '58870b8100f7', '216ad8769098', '971a1d89a2b6', '8c53c226715f', '414358cd1aa4', '1dab3b3eb3ac', '9db8896ac899', 'cae6d8de0cdc', '89dfbb052a80', '5c0d62de133d', 'd4f0d2e04f0f', 'd6796c9717cb', 'cd1935758477', '3e6fad4a3ceb', 'deac999fad9e', '5ab62874d74e', 'b34e0299c0be', 'f043792c803c', 'd9c5043eb7b7', '8af9da778df5', 'b0ebbc59ea6d', '815635929cdd', '0a1d5598032a', 'e0b704352dc5', 'd657d172889b', '59aa5e66d04a', 'abe34ba37c70', 'dfcb9a4c811c', '583696cb057a', 'a9528e7779d1', '5b9639b8d45f', '932bf4859717', 'ca03925c41d2', '7bb2962a251b', '1cedf990a0e2', '6db6de46f412', '5212a4335885', '751454ddf950', '891632f7b8d5', '0e7602aa9547', 'ea5ff754f6d7', 'c63627c1463f', 'fc1c206de4c2', 'e6f0afaa8b14', 'd40cbeae513c', '9241a3a9c061', '070d17b7a8b7', '2bf78f80a357', '9ad8d1824fe1', '71d2a69e8971', 'c118ff4fffae', '5fe4c5d579fe', '1468c539952d', 'd763c2eb7d91', 'b1182bc011df', 'dd60de4787cc', '89ef66e24b1d', 'ca1c95c006d2', '8a541fc4024f', 'b78a883cf91e', '1a81fcfe8a37', '205e520da43c', '79e791d677ec', '482d479615f8', '98c24128dae1', '7ec8458d9730', '78228ff222e0', 'dcfbda520fd7', '9ff7db3bd0a1', '2ff341fe54db', 'ecf0a44949a8', 'a96c075a0686', '62d187c4e86c', 'e7712dbba9cf', '63b2b94baef3', 'bef10c390e73', '60bc1e767e0c', '1e26afa1039f', 'e33d02c9d550', '34de2529721f', '369b5b9740ee', '84e09afe127b', 'dbef422e3917', 'cb2ca703925c', '741f5cb3eed2', '9f146b701b10', '31699f076f55', 'bb8ed59138d9', '3370c1fbdd21', '13bb0371905f', 'd8ebda8b3552', '564943a36fcd', '67ae4c113a1f', 'ea7fc6aee6ad', 'dcec9445abdf', '9a16ce4e88b0', 'cfc8b35de990', '78bd69887d81', 'df240a81f920', 'c83c5de8a89c', '9f69608e012e', '9d240adfd5ab', '799c33482a58', 'dd19b90e9eff', 'a44a230684a6', 'ec951a771245', '93bc0e5f4b84', '4b997c094a89', '42c340bb0abd', '12deb738518b', '5235e2deccb4', '191054785693', '542f1b1f774a', '8eccdeb8a245', 'bd61d2c7397f', '27d470b67f78', '23a73c175e42', 'a87d607fc401', '6a98e6502f93', '30c9aada6631', '6119ef4201c2', '0664930be99b', 'a4e263dfb890', '2d70f29cb318', '7c2358b05b8c', '78c4810c2f7b', '7cd33495a0ba', '161a6dc7cfce', '3b9bc66dce5a', 'd452fe3a8150', '7b1dfe0b61db', '6c54b06d2db1', 'b8ff23853fef', '083c08861e7d', 'bb6f3b105d4e', 'ce3df2068d5e', '02aeb5eb661c', '5cc0fdb55644', '1862b1bc2829', '6b4bc692577c', 'ab6ee9cdc635', 'df2ba938e9e3', 'fb9f6b4300c3', 'c06d760518cb', '6a687a220851', '7a1c9c02c6b8', 'ca907b3eb8ae', '251d1a89b40e', '805017c6e1de', '35fc01ac86a5', '803bcf371db6', '3fcf9663b41c', 'dcfc50020ff5', '470157270ad9', 'b4109e9d76ae', 'bfa8a0abc913', '46e2a6d7269d', '5dfcc209dd27', '57aa33feadb4', '12355548c278', 'a50fced59e40', 'cee599601787', '518f51a1401f', '00dc252c91a4', '0b5c9710f84f', '4382f0ffd5f9', 'e7acd8475f19', '53d93991ea20', '4f13fdcd83e7', '2d6fb375e9ba', '993583860283', 'f00aa69c6c32', 'cb1a207f3e1f', '46d9e0b4038b', 'dd0c3c660103', '2050d31c8b94', '5f7ec9efdc2e', '6960593c7242', 'f13e8993c343', 'cad730369432', 'dc81f29f8162', 'e462469661c7', '311d38037c4b', 'c02ae0bd3b13', '0b9695c09a79', '1d6d41111d45', '97d5c84e49f3', 'f5f9f610a21f', '06e672ba60de', '65fc1dd9cc16', '089030ecc645', '81e71017525b', 'e01186ba961e', 'e786309b1377', 'd8519c401709', '99d1735b8e1b', '3ab6b2e6e1a6', '1317b98bbf14', '9044bcc1f113', '3dc5dad65709', '1447a1a773fb', '2c4b28da8296', 'e68b81a71830', '6de010a49d6f', '0dbeeb52544f', 'ab9af563530f', 'dadb629aeeef', '7a289a0c08b4', '45f6f631d8b5', '97903bb70d9d', 'b3b727e210bf', '73a9eef7b5fe', 'd2d397d58e39', '59d74e4a80c8', '3cc561cc9b3a', '1d2c6a192e1d', 'e72c41955e59', 'b259f44701fa', '97d06716fbab', '5aef2272ce3f', '14f6516edc88', 'a9a84b501cef', 'df18c5aba915', '5e7b1c46bf81', 'beaf43b6ca33', '42f340f1128f', 'eb9116fb53d9', '69121621e11a', 'a0cdf7b17732', '95ed1c13c7ec', '0c8e47f78861', '721757daee5d', '2507e530c335', '9a32a097d6c4', '026940e336cd', '8fc9eb0fc9f2', 'cb09136173a2', '8c6ac8006b7e', '45c99c1fd057', '4e67fe67eb75', 'ba8631fc7874', 'c3e168dd8c44', 'de0e25f2aa29', '7c31ff7543dd', 'cd47f84586bc', '920f735ace74', '3f0504656d05', '055ee18f4724', 'f346435d8530', 'b37ba9e08c0d', 'cd7bb163e327', 'eb9088f24f6d', '923b22a9eb10', '7d7e1eaf5961', 'ee79b8b3e8ed', '69c8fec6d5b5', '98f8c3323b35', '60bc318b9591', 'b246e88a3150', '5f635b12e95a', 'd6e6b408e5b2', '1c3b400081c3', 'ee8ee7dc29f9', '5485f5657ccf', '3711e7e41edb', '78415188f322', '591ad81a49c1', '404507ba1b90', '312faa30f69d', '494fafcbd219', '784f17ba49e8', 'c3913b4ee818', 'f9c344b72d25', 'b5476b7db07a', '7d3d7580b215', '5bc9b2910653', 'acbfc1f5e42e', '38c6fbd5570b', '33ee4a34a326', '247ca611aecd', '9834b3c32e04', '7c6f8ecf0c7f', 'df2372d64728', 'ca005710d244', '67514bd4dfce', 'e9e7e15f6030', '943d78968506', 'ec72cfbfd793', 'e42f0f467ed6', '02a0f551c862', '0d3038b4297d', 'bebf351e8026', '26d0da1f3d44', '0c7ed0e4d49d', '2c9554a5ce21', '93ca4f4ecbea', '668e7702f664', '5d8665c5688e', 'e608eeebfaf1', 'e8f3aac0bb5e', '430f205df8a3', '96ef551ed017', 'f8c835e4b95a', '570e4aff0aef', 'e7acccec07ba', 'ba03b1b37f63', '27237b89f8b0', 'b6ccb09af3a1', '9dd067d47d80', '207ceaf4e61b', '3df97da3a368', '5df6bfd3b9f8', 'd0bebc1c4acb', '4f5f594b0a7c', '51f70640940b', 'bcde574033cc', 'e28c3585dae9', '3f29c925eda9', 'e0aa71411353', 'd373027d4f40', '3b14af2b91e4', 'e6b2e50f29b2', '54bb1a033c5a', 'f0ea15e04680', 'bf36400119ec', 'e6da8a4cde9c', '5463c030c431', 'f5e5f815e3cc', '1ace9ae1ac77', 'd6f0e461849c', '98078d584c3c', 'f51b94c0915d', '7f14c58a0e41', '8cec2459ee56', '6aed98300456', '238fd38f9be1', 'bbf50b88b4cd', '5b895d83fe52', '6d789fa5040e', '17e6e88275e6', 'bc044626de61', 'dae6d2603226', '6f907e235c4d', '15ed31a68114', 'c3be9fd08292', 'b83cddbe2973', '9ee0c15990db', '5e8e1cfe1e34', '0bb10bb324d8', '122fb80435aa', '11d9809786b6', '9d2c53863f28', '94ee17bc18ff', '86fc843cd67e', '0af503014a73', '031ef25eb5fa', 'b589635750fb', '54d21269990c', 'e95c33d4b6a7', '89ce8cdd4375', '10c3bc84950d', 'af1da0514302', 'a2134e0b48f2', '286808496542', 'ca2dfbf6633f', 'f6ff03be91d6', '2c5623dcb74a', '9bedc83f0d39', 'bfc1a3e9e949', '796459c48e00', '851e44e86aff', '2fdeb88234c7', '7d40dab4c70f', '060e69ab3d92', 'e8a85d8b4edc', 'a1f1bef5a888', 'de8b19a395ac', '6a57d13bd5e0', '24e729b2cf84', 'eb5244927a7c', '532186976fef', '3bd2c10adc5b', '7ff3d7752633', '1c4caf6762a4', 'e02bd251070a', '76472abbfb84', 'f059d012a354', '683d949ea529', '51036dde98a4', '356aa2417e03', '8959de031856', '43cdfdec57fb', 'fca918cc0948', '722c1c1142a2', '86042b11e8fb', '038d589076d9', '57c94a5c42c2', '7a4c42a46269', '4872e6af60fd', '6f28fac3ca6f', 'd9635ba51085', 'c87e01ad132c', '2d8fa43c1f20', '1fe7241e0ef0', 'b8a568986d52', '1f760252cf0e', 'c0b99fc54d3a', '4ce29cbb1ca6', 'ebdb77aac1f0', '2a0acd33c708', '0206aca18bd2', 'e8469e75b369', '45fd123f8633', 'd1d2cd769557', '9d6a75cb0aa1', 'd4bc8075ff8f', '9abaa75f2bf3', 'd84d5b1dc296', 'cc976dc254b2', 'd98ead4603c2', 'd715aa82ed11', '17f3091fa2e5', '277953d7c46a', 'e52dc9183aba', 'fe3fdce10475', '23bb40d5916c', 'c1c4a58dc9c5', '88bb74876eb3', '9dbeb4ae0f5c', '3305df033487', '124ae635deaf', 'c7cf4d87e215', '8d1df410859a', '95cf1a4f0e17', '038aa7e20102', '6186c350fc43', '6f1b1f609713', 'ed930f6cd76a', '394b09f42c35', '8910c1cfef95', '6d019c0af229', 'c28084e7a3f0', 'b1a4644d3bb6', '412fa5bf7ffb', 'b95a60349c45', '04a492bb71b8', 'e92c130a1771', 'eb1d7530eb6f', 'c1f518010685', 'cafcfad84d8b', 'b91a1a8c7aae', 'b6751bab88c7', 'a0788d25cd27', '300fdcebe983', '2f17aa1ea1eb', 'd3b477d1f717', '4c46b7be1708', 'ba8ddf2f24df', '2fbf33622fd4', '7c71398fbb39', '8098eeb614eb', '2a88bdc229d7', 'f1627b188277', '65b23fe83635', 'c591e2d008ab', 'e79efccfb65b', '95e0d4d1df8a', 'ea0ac3a33d3f', 'bf1c6524eaa7', 'beed24bc23ac', '63c22d49bd38', '1ed54a054411', 'fb60a044cfa1', 'f748cd37c53b', '90ee50720046', 'a8d3df2cd555', 'df16f8a69af8', '8e8c7cbfb70f', 'a033ca5a3482', '79504cd833a9', '71800e077716', '7a9a2ccf489a', '2d386989bd78', '7d772b6d06e8', 'fbaa9db675ab', 'b2816f5d05d5', '6ef3d82ab405', '3de58fcec0cf', '047f8e38fd27', 'b0313840299d', '0848e09c1913', '5f0938f5a831', '8504a29a45e8', '0d005f671a15', 'd6da8ec92020', '61ef19006fdf', '7889562f93aa', '11a2baeb4740', '14fd18628ad5', 'dfc755fce1bf', 'dbdb9cdd9ce6', 'f88306d0c4f5', 'a887daa0b1f9', '4e0d585cc1f5', '60bce1dff718', '6c210996d16f', '24718d9dce9b', '41871388a237', '64db81c64924', '05200250ab7d', '91bde6a33f40', '3516502d51fe', 'fedbd7fe8843', 'db48d8ada543', '04357f12c612', '2257a478ba50', 'adbd3d452010', 'db09bf52082d', '5a7ccc2369d0', '13ef12f2ce95', '3d4ae84ba358', '969677deb611', '8c757a66d1f2', '10510c05c8f9', '4d60204a010a', '734f2c2b40a8', '2e03d08f5a85', '6b47a866b1c4', '5e653638d903', '479709d1945f', '3020bd9a7511', 'a14c38e1ea1d', 'dc24695f1544', 'f481b0ace276', 'e07a99a0641a', '4ac553cebecb', 'ae2c42f2d7b7', '837a0f2a3d88', 'f6168e5589bc', 'cd46e8af4002', 'ca206c890fbc', '6995f9a8b51b', '16c19bcb4c13', '9590f42b388d', 'ca7a02b0ace5', 'e7d05b0cdc40', 'ea23a01498fc', '0dfd902b4d55', '49caec962345', '937452257eb5', 'cb2e1a447fd4', 'd93124c6969a', 'a414e919edc6', '801cbda1bce3', 'dead42091427', 'f718b5bf25d5', '85cc487c245a', 'e755f861f485', '9f9b709899ef', '399619a64b10', 'bced9d27a46d', '01450b541114', '2ec568a42e8a', '351b563013b8', 'c110e374e046', 'bc9ca832c2a0', 'e546cd9752e8', '060144b83d70', 'e824cfc95013', '013ae8d7c7eb', 'b4ae714f5cb9', '6acff2832848', '50620f424f62', 'b2ed2e832c16', '6e8f874a39f7', 'c38962304a48', 'fd978043a149', '1b92886c4ce0', '8baf860e77e2', '56669347d014', '1ffb5ee38d59', 'a80a1ea17557', 'e6409e87cf88', '42552b58cf82', '25bc9abd18f9', '7ebc3bb7b0a2', '02191d35463b', '5707a94ae956', 'ae972733f046', '47b9a2bc4ec9', '610d8da5bcaf', '4af67e0a9da3', '25436d199d68', '41d7f022ed9a', '915fdbc321fc', '481ac12554d5', 'f271279f6df9', 'f5f0e0140402', '377c27c6bbed', '7cdda2d2ec9e', '5c1a1bf12f84', 'dee01a5586ed', 'd0bae111fc4b', 'd73803f32e28', '4d3f50f55e58', 'fe9c6c325a9f', '119976c303b5', 'f0824134e92a', 'd52b3aab1133', '37d436f45be8', 'c992be33d763', '08498441a96b', '7e3996eeca15', '7b5986aa3031', 'e2fee8568926', '113b4b967527', 'b56eae1a3395', 'bad816ccd54e', 'de45ac50ed0d', 'a134008e4e08', '062683140d18', 'a4859475a6b9', '9377fe9b8fca', 'e4f5f926b47a', 'ee16c579633f', '51b6560040e6', '7804a11c411a', 'aef1ce0b7186', 'fb4070e2671c', 'a2ab9d438c1f', '57d2be77a77e', '3396c4e635cd', 'aa42c20099f8', 'd5b6e2ebd67c', '9ab656fe2698', '402aae50605f', '5619822e4aeb', 'edc24955168e', '438e0af9a7a0', '445601e5fa5f', 'efa04bdd1c1b', 'cfd859a95a0b', 'ab79276db45c', '430f2fe52d04', '2aee2c338442', 'efb87e3d92f3', 'e549601e37cf', '68218cdedc9a', '6c11def93d3d', '4fb7c2ea370e', '4ff3f4aae9a3', 'db10627c075f', '028a98b72739', '855b40a0817c', 'b4091930206f', 'ac0a2b7ae199', '15b2fc76c765', '8b6adb5ffa9a', '461586036ab9', 'e04b6bc45fee', '3ad58faa21a0', '2238a06b214c', 'f08166675957', '03b51d8fc989', '4fc619c44ed0', 'd54673bd9807', '0c53c78f242e', '566a38798316', 'f5aa5392c91e', 'd5da87385afa', '5d508dbe8662', 'c35123e75468', '4671166f8a17', '317c27ccbde7', 'f605931ba5c6', '0b63b79978a5', '05629c863563', 'a6e2bacd17cd', 'f8fc8a224ffa', '78ed7b1d85be', '2c43be7c0a4b', '80b9ccc0b1e3', 'af8e0f6f7f39', 'a1d9c0eb27f7', '401254977ae4', '4c5c8d956cd6', '0b28015ce567', '81af244c9b27', '2c3735673d4f', '7584418f5895', '50d00784867c', 'a556b0a4b4a4', 'd51b6af0c682', 'b12300fb82a6', '002c326a1300', 'dc5e425c12e7', '59bf15f4b1f2', '14d7b54ec4e6', 'eb3164b4ef43', 'f21148eb12e2', 'b9e3f347fcac', '2e3ddfd7de60', 'b079e7eb0232', 'd7eb62470edc', '0326869f6a65', 'fbc106c77bf4', '7d3916feb892', 'eb68cbb3ea3f', 'dc57ecbd69d3', 'd330a5c021b0', '53e2549550ec', 'ef8082d61d62', '6425678c668f', '1c54fd64b17c', '9eda44455286', 'c1ff02727874', '328ea1dd48be', 'fd45a4b78bb1', 'c31526ab4865', '6ed4bedc89be', '542b437dfde9', '8c2c3acb5843', 'ddd4888e771a', '7e304e28b579', 'f1a467817a03', '4671f8487e46', 'b92b653ab865', '7f1ebe1d61ed', '26b8e1ceb97e', '17755da0a52d', 'cd707c99a3a0', 'e5703859752e', '44e52f850771', 'fc7d0ce0c85c', 'a2fa9aae3ac7', '6148bb02869d', '5d6262c78b44', 'db0fbb841e47', 'bfa5e933f698', '15a8c8a4315e', '0e7b8008406c', 'cf95473010d3', '008c078815c2', '4841dd537414', '568ed063d7b5', '6489750f80a3', '0b5c45a92509', 'e7fb5aad42c8', '77a6b6f2d6aa', '13fae746cf6e', '097821ac9ddb', 'caa76175aed2', 'ad28f2e6809d', '2a0f65fb70f8', '68e58e890686', '99c153bbfc7b', 'b1ff4f905001', 'be12951e1dbc', 'c53a1f58e997', 'b56d9eded457', 'd9214ac7c34d', '521c7a33fa07', '9db2ea2ed6d5', '2e625c1e4110', 'c44e746a5a72', 'b7a6efd5102f', 'ebffc8a5ea90', 'c4f21debeb8a', 'dfc006d983d8', 'eefe21be1d3d', '6b805d5568db', 'e5e1f52fee37', 'f934bccdffc5', '5d40829b9d51', '06203e76900e', '0cb97becac95', '326c05f935b9', '553935018d04', '0b7b42306874', 'cd081724f95b', '1baa63d90d80', '9aff5f5b908c', '623268fc2e04', '6770017f373d', '514e26102b38', '30b9dffc4b01', '6e99c69bf833', '06f7238e2686', 'e0928e9f9b8a', 'db3adaa63dc2', '55f6cc795b9a', 'c56f60c58579', '7274a4bc0845', '5ebf90a77bae', '52e5a569b2fb', '3ac323307659', '08b8654d60b0', '163701b81a91', '6e8b89c62757', 'a45449c43ccc', '54d3133697d3', 'aac9074a3ae4', 'f6260334ac16', '0c7fb860c377', '82c325d9ff55', '2d73ae377115', 'e765661bb2b6', 'c2107d77e817', '56f12356434b', '15dfe6f6f317', '41f36c41bd62', '328adfef2803', '14c998569c4c', '2fc1a9cfb653', '564fe1d3252f', '163eca15c5bb', '21b280004f8f', 'f81086dad693', 'a2bf39f7d5eb', '22e412ae7cdc', '3d258b853028', '04eb141c1dcc', '2817ae15a198', '99e605804790', '555b7c0c174f', 'f4f345f516a1', '30c1c1cd25f0', 'fdb8cbe64008', '66e379aebf03', '32bbca5ee1bc', 'eec60758a2b8', 'dd2c45874196', 'd9a18d0afa6e', '1a9cf149b20d', 'bd14417ecb7c', '576b101f5897', 'ea2cb1e8bfd2', 'e8cc911075dd', '5e597af1c5dd', '85d18a12ba46', 'bee801c5e76b', 'ddb7f2d369ee', 'b79b9f42f61b', 'e754893240af', '9355a9fa24c1', '5b6803c05c9d', 'ea51e0ac69d9', '3a0cd8aed950', 'b8c42c4448af', '6da72b417e67', '8c4fd6dd575a', '85ac0eedbcb5', 'eebcf4c39899', '693183fde0f8', '8d7b835d798d', '55aa5a57204a', '4fb3caf2d427', '95034fecd88c', 'b627cc699e5f', '4be762e345d7', 'ac99ad3bb9e1', '96a9c2c11d2c', '9bae60dda417', '1912d8b09c02', '1aae0e6822c3', '164b70d629b8', '25147834740c', 'b312837379f9', '8b89ae7eba7c', 'a1ebd176fc96', 'dcb8ae2e29f0', 'a866045abfa4', '2353e7ab4ed6', 'a2e3e297d5b8', 'eee360b54773', '09ecf394b915', 'fcfb543d18ca', '5ef9ddd8766b', '278b21056f05', '503ddd3343dc', '076f731d7aa1', 'b95118aeca5a', '4f0928bb7ef6', 'fc3e102d3969', 'a536fa5a2c27', 'ef21fa2dbf8c', '8961e8e67160', '576f131cda26', '51ec38142d56', '29693cdc482e', '3258ee295406', 'e8bc6f941846', '2355aa54bc82', '8900904c12b1', 'e55863f9d072', 'ac19d0b3ff84', '0996efb5561a', 'c6b245fe4562', '00ab6b9351c3', 'f3483e4306cf', '9646bd5a84ce', '9f1bcc5c6965', 'e135b3912cef', '94a115e8fcd9', 'b326768ebde4', '21ea30b9ba6b', '876b8271a352', '3d0e20167212', '54a78825f282', 'c79487c22b95', '9e2b50fd345d', '887df275832a', '4d11856b586f', 'b8c1ea7a2849', 'fc50a52eab7e', '465759620911', 'ab43c4adac19', '4cbfe1124329', '8dc81e39f643', '0de2a2766d62', 'ae017bafc607', '5c570f90f020', '7a5ff145abbd', '92f765ca7d70', '0be4c96c3b55', '22d069744b1d', '01de0d81845a', 'a66c4107c1a4', '4c0f1d634c7f', '2d860ecd5c99', '12ec95aa2458', 'fdd0f399ca77', '43145d22b71b', '30f740924a41', '05149a2941aa', 'fe4d4dd2148b', 'f36a864d95c6', '26c25ff4368e', '1fa02e70de43', '5e7a2ba8510f', 'e2f95b38d1e0', 'a259725b06b5', 'f22ae722ee99', '540e5a2f20ac', '5a3717797a44', '6b4bacf007db', '7b6b50523166', '750d1650f72f', '08dc31e77993', 'e702e2694538', 'a695c32d3708', '870b4c614f5e', '15ab40294ef7', 'b60d17ab9031', '3ccacd99b97c', 'c10bd38c8458', 'b7c790749535', 'd9fde5328543', 'ea5429e1666d', '17698df9db6e', 'd9857021b538', '2d2ef7fe8fba', '6fe81b19c87b', 'ba83914c432b', 'aa2c0ea205fc', 'ee25f6cd622d', '610b94a441dd', '5daacb4ddb17', 'df3c0d951be2', '030ad5f753c3', '05c41e5d41f4', '80df4a8b678d', '791bd1f2ebd5', '16fcb5d0f4fb', '0bfa25d38fce', 'c06d37f24c0c', 'bcc305f4f5ce', '620662801920', '615010ecfbf1', 'd772ba2560ef', 'fb1cb47f63b6', 'e32ddc540f3d', '6b702d47cadc', 'f053a311f3db', 'b0eca5d58e4f', '70a93bed3e53', '69c3d4f005e1', 'b64b3077b598', '72d9f096db38', 'ba7cd6c9e5a8', '417daaead8d2', '18eb6fc44282', '8486a12fdd76', 'e20036ecdcf1', '9b6fbf4582af', '3b84e587514c', '453b1095ff9c', 'e98fb9c72a4d', 'cbf87b90dc4f', '86b9d3b19302', '627e0effbcde', 'c808ac16f746', '0b3c5eadc19c', 'ba9940dd0ace', '2f374c127271', '2926c836fab3', 'bdfd438264f3', 'd561f9ea6a05', '567cd7d6cd4f', '939eedcc7e89', 'aabd6f3f5a3e', '153bcb6102ca', 'f1642cd449bd', '183ef172ccb9', 'a26780b4ac0b', '463082b9589a', 'da20201b9167', 'e045a124c0aa', '67671435ca6c', '80c0bfdb2c2e', 'b8e528812ce2', 'ee0ef6b76c3d', '6695b284581f', 'b9b2e50c01ec', '51d2b2017898', 'dc9fd390d10a', '5072d598f73e', '570cdee644b7', '5255b9c6f617', 'ae3698adf0c8', '7d82a309f109', '84e39eb0858d', '74f977c5b10f', 'aeaeeb14faab', '183d91af6f37', '568f05567178', '3c77c60de428', 'a141873433cb', '17f7e2ffc64b', 'a8c905264b79', '1cc1d85a3bf9', 'b1f3adaff0cd', '8395d53e9689', 'a661494c1b01', '555c7823436e', 'c9c526a69a9e', '043c55b755d8', '91cd01e23bb4', '8ed4a8752e8a', '1672e9192843', 'cabbe4173fea', '0f44ac5928bd', '59bfdc76151b', 'cc7cb5dd51ae', 'de3fcdbcbb09', 'e70b124a1ef6', '75bb262610bb', '15758389691e', 'cfe00c585ff9', '955164f19483', 'b5d5c56d25a6', 'b7e2a318ea9f', 'b58d59eb8789', '6c59ce3a9fa4', '66cb6e8a9c58', '6a69cc59d55c', 'da51c31824f9', '8c0c92f32905', 'd18a98a0889c', 'ec3fb050ea07', '7d427477ae57', '2ffcfd321241', 'd7f38f26ea7a', '513ebf7947e3', 'bf5aa2c9d8c1', '5ef3ef2b598d', 'a81ef67dab18', '5381e1aad470', '6fccb36e0b57', 'fff37531ca06', '3d4bfc9acabd', '322fc0639ddb', '54964e9b2d4b', '00c44410f31a', 'cd5833bc74be', '6a133d855ab4', 'de613f903e96', '7771fec3b6a0', '412373e3f3a5', '0410a43a682a', '4d17fe16caa8', 'b859302a6889', 'b6a2112d4e80', '1d32499b7135', 'c49403d95d7f', 'ee5dc3645dc2', '9bcdf654fe3b', 'b44f4fa090b7', 'bb2e304412b3', '273b874fa547', '3aa49669ce7c', 'e41ae9d5b589', 'cb82bda70e10', '8f41e7ccdd22', 'b7249f2b425b', '29040f455078', '43e71027ddd8', '5fe9292eb6e0', 'bd872e71528e', 'c741f021e196', 'dc062e917490', '5f1e5e91bbf3', 'e4ff9f30170f', '420008058027', '309d2dbfbbf1', '38dda422f04a', 'f0f980c7f466', '1c4977da2499', 'bef1d365c944', '54a91c4434fe', '85924641e5e1', 'd04d1de4846a', 'cb5157e37d72', '93fe699e2a8b', '98ba50c957fa', 'f4ac2542ee7a', 'e6f187b2d97d', 'd110df3dda1e', '9f2489abd583', '37656310a4a4', '93448c3ec842', 'b5db5bfea661', '3103d2af189a', '90a2bb30cff9', '6d467d891704', '17fbfcf04287', '145b5ef4d782', 'f528024675e1', '0caed5af4a54', '782b4da51345', 'a17803d55c89', '3f4cef515900', 'c917a7d38247', '64058e0ae976', '264817dcea7d', '14c2a350a738', 'a3170a92eeaf', '758cf51765ed', '48a7f69f3ca9', '2e84e4268f3e', '930c8c68f138', '978ea94de899', 'ca7b4aece8ab', 'dae6e4a93649', '1b9d2da05995', 'c9eb6e64806e', 'aaf9585bfaa9', 'e2e7b040d643', '8d0166ca524a', '57648fac6761', 'e3144740394b', '5e975ded4c01', '90e951e87a03', '72100859fe98', 'ff107a39abb4', '0210800d2146', '2055f22a7152', 'd93f0a22060f', '962069f9933b', 'dbf725d38052', '9b334ccd801a', '011940b678df', '5421f137a11e', 'f84ab35e83a0', 'f04365d134e5', 'cfe0863ee579', '6242a73e4ca2', 'ed34be050508', '720134bbf38d', 'f8a6e8f9d27d', '444a19b0ccb0', '7a1a93550585', 'd47a95cb9f7d', '5f4d3d84c64c', 'd2f0b97329f5', '58c466127666', '4ae1af976834', 'c415dd1d6379', 'b8be63d9331f', 'babd3bccd6d0', '84551455f861', '90896caf28ea', 'ae54aea8a5f3', 'b99ae641fb66', '4669c321b7ee', '653d92866ab2', '9d68828a71ad', '99d7d0b40140', '2a98a9f97e61', '7395ef335917', 'bfe0b23703a4', '632d08c5a94c', '5032e48135e0', 'c81bfdad6e9d', '878ba34ab010', 'e59170fcb6b3', '150d8a9ec37f', 'bad693a1eb57', '23bb8dbca224', '8e2ddbd164f7', '872b1896d850', '7146220a7446', '1abcd64562ed', '3612a2fbf3c6', '5bcc87951dbe', 'f19ed64cb934', 'd69f29ac6bd9', '106e0adc4fb8']"
d+c@*Cc<CCMK9,0,"['Lock SSH directory', 'Save SSH key', 'Get CPU counts', 'Get crontab deamon process', ""Get logged user's activity"", 'Get system info', 'Get CPU counts', 'Get running processes', 'Get system info', 'Get system info', 'Get current username', 'Get CPU model', 'Get file system size']",1,0,0,1,['e75252abce93']
d+cN!TO]C@*C,0,"['Lock SSH directory', 'Save SSH key', 'Get CPU counts', 'change password', 'Remove security features', 'Get CPU info', 'Get memery info', 'Get where ls is', 'Get system info', 'Get crontab deamon process', ""Get logged user's activity"", 'Get system info']",0,0,1,1,['481dadcea885']
d+cNZNTO]@*Cc<CCMK9,0,"['Lock SSH directory', 'Save SSH key', 'Get CPU counts', 'change password', 'password prompt', 'change password', 'Get CPU info', 'Get memery info', 'Get where ls is', 'Get crontab deamon process', ""Get logged user's activity"", 'Get system info', 'Get CPU counts', 'Get running processes', 'Get system info', 'Get system info', 'Get current username', 'Get CPU model', 'Get file system size']",1,2,0,3,"['e9c706f4a1fa', 'd10fc238189a', '99e3cfa3b269']"
d+cNZNTO]C@*Cc<CCM,0,"['Lock SSH directory', 'Save SSH key', 'Get CPU counts', 'change password', 'password prompt', 'change password', 'Get CPU info', 'Get memery info', 'Get where ls is', 'Get system info', 'Get crontab deamon process', ""Get logged user's activity"", 'Get system info', 'Get CPU counts', 'Get running processes', 'Get system info', 'Get system info', 'Get current username']",1,0,3,4,"['cffc286aa751', '2d84aa954396', '3cbc905ffc45', 'bd4ba787db79']"
d+cN!TO]C@*Cc,0,"['Lock SSH directory', 'Save SSH key', 'Get CPU counts', 'change password', 'Remove security features', 'Get CPU info', 'Get memery info', 'Get where ls is', 'Get system info', 'Get crontab deamon process', ""Get logged user's activity"", 'Get system info', 'Get CPU counts']",0,0,4,4,"['2dea23a2fd6c', '5ab9ac23b2fd', 'd0c3c51363e5', '506c74221cce']"
d+cNZTO]C@*Cc<CCMK9,0,"['Lock SSH directory', 'Save SSH key', 'Get CPU counts', 'change password', 'password prompt', 'Get CPU info', 'Get memery info', 'Get where ls is', 'Get system info', 'Get crontab deamon process', ""Get logged user's activity"", 'Get system info', 'Get CPU counts', 'Get running processes', 'Get system info', 'Get system info', 'Get current username', 'Get CPU model', 'Get file system size']",0,0,1,1,['d8cdcdc9d15c']
d+cNZNTO]C@*Cc<CCMK,0,"['Lock SSH directory', 'Save SSH key', 'Get CPU counts', 'change password', 'password prompt', 'change password', 'Get CPU info', 'Get memery info', 'Get where ls is', 'Get system info', 'Get crontab deamon process', ""Get logged user's activity"", 'Get system info', 'Get CPU counts', 'Get running processes', 'Get system info', 'Get system info', 'Get current username', 'Get CPU model']",0,2,11,13,"['2385de744c4f', '16a7acb7ff36', '34e5454f46b7', 'd045f5ff445e', '037ac02a5061', 'bcb9b9eb1fd5', '535b46cc8ed3', 'd044f5e0bcbc', '098b78f52be4', '0aa9da9be231', 'e9ef246e2d2d', '59b9923040dd', 'bc0187a9df5d']"
d+cN!TO]C@*CcCMK9,0,"['Lock SSH directory', 'Save SSH key', 'Get CPU counts', 'change password', 'Remove security features', 'Get CPU info', 'Get memery info', 'Get where ls is', 'Get system info', 'Get crontab deamon process', ""Get logged user's activity"", 'Get system info', 'Get CPU counts', 'Get system info', 'Get current username', 'Get CPU model', 'Get file system size']",0,1,0,1,['cdf828fe9319']
d+cN!TO]C@*Cc<CC,0,"['Lock SSH directory', 'Save SSH key', 'Get CPU counts', 'change password', 'Remove security features', 'Get CPU info', 'Get memery info', 'Get where ls is', 'Get system info', 'Get crontab deamon process', ""Get logged user's activity"", 'Get system info', 'Get CPU counts', 'Get running processes', 'Get system info', 'Get system info']",0,1,1,2,"['285e19cfba04', '41041a49e752']"
d+cNZNO]C@*Cc<CCMK9,0,"['Lock SSH directory', 'Save SSH key', 'Get CPU counts', 'change password', 'password prompt', 'change password', 'Get memery info', 'Get where ls is', 'Get system info', 'Get crontab deamon process', ""Get logged user's activity"", 'Get system info', 'Get CPU counts', 'Get running processes', 'Get system info', 'Get system info', 'Get current username', 'Get CPU model', 'Get file system size']",1,0,0,1,['1afbbab09b79']
d+cNTO]C@*Cc<CCMK9,0,"['Lock SSH directory', 'Save SSH key', 'Get CPU counts', 'change password', 'Get CPU info', 'Get memery info', 'Get where ls is', 'Get system info', 'Get crontab deamon process', ""Get logged user's activity"", 'Get system info', 'Get CPU counts', 'Get running processes', 'Get system info', 'Get system info', 'Get current username', 'Get CPU model', 'Get file system size']",2,0,0,2,"['3e7e3d3bdbe6', 'fec4716e145a']"
d+cNZNTO@*Cc<CCMK9,0,"['Lock SSH directory', 'Save SSH key', 'Get CPU counts', 'change password', 'password prompt', 'change password', 'Get CPU info', 'Get memery info', 'Get crontab deamon process', ""Get logged user's activity"", 'Get system info', 'Get CPU counts', 'Get running processes', 'Get system info', 'Get system info', 'Get current username', 'Get CPU model', 'Get file system size']",1,0,0,1,['f5947b5e1d62']
d+cNZNTO]C@*Cc,0,"['Lock SSH directory', 'Save SSH key', 'Get CPU counts', 'change password', 'password prompt', 'change password', 'Get CPU info', 'Get memery info', 'Get where ls is', 'Get system info', 'Get crontab deamon process', ""Get logged user's activity"", 'Get system info', 'Get CPU counts']",1,0,9,10,"['036ec0c6c2de', '00a56f05f050', 'f4189d58a0a2', '9d3b284a6724', 'bfbdc02920c4', '88324c015cd5', 'b635a76a6b72', 'e60e7ebaab90', '2f8bd8b44f7d', '26775af574e8']"
d+cNZNTO]C@*Cc<MK9,0,"['Lock SSH directory', 'Save SSH key', 'Get CPU counts', 'change password', 'password prompt', 'change password', 'Get CPU info', 'Get memery info', 'Get where ls is', 'Get system info', 'Get crontab deamon process', ""Get logged user's activity"", 'Get system info', 'Get CPU counts', 'Get running processes', 'Get current username', 'Get CPU model', 'Get file system size']",0,2,0,2,"['ee4e6456a443', 'c801f7b33019']"
d+c!TO]C@*Cc<CCMK9,0,"['Lock SSH directory', 'Save SSH key', 'Get CPU counts', 'Remove security features', 'Get CPU info', 'Get memery info', 'Get where ls is', 'Get system info', 'Get crontab deamon process', ""Get logged user's activity"", 'Get system info', 'Get CPU counts', 'Get running processes', 'Get system info', 'Get system info', 'Get current username', 'Get CPU model', 'Get file system size']",0,0,1,1,['16adf148cc51']
d+cN!TO]C@*Cc<CMK9,0,"['Lock SSH directory', 'Save SSH key', 'Get CPU counts', 'change password', 'Remove security features', 'Get CPU info', 'Get memery info', 'Get where ls is', 'Get system info', 'Get crontab deamon process', ""Get logged user's activity"", 'Get system info', 'Get CPU counts', 'Get running processes', 'Get system info', 'Get current username', 'Get CPU model', 'Get file system size']",2,0,1,3,"['75cb98d1bd90', 'e345d216f8cb', '77814b08ade3']"
d+cNZNTO]C@,0,"['Lock SSH directory', 'Save SSH key', 'Get CPU counts', 'change password', 'password prompt', 'change password', 'Get CPU info', 'Get memery info', 'Get where ls is', 'Get system info', 'Get crontab deamon process']",1,0,7,8,"['18ec628f317e', '66c43f84e9e8', '03f1491cca9d', 'b51df4e01260', 'f216a38823e9', '24b9dbc8f5fe', '7c373afbc6d8', 'ff9e7c246c28']"
dcNZNTO]C@*Cc<CCMK9,0,"['Lock SSH directory', 'Get CPU counts', 'change password', 'password prompt', 'change password', 'Get CPU info', 'Get memery info', 'Get where ls is', 'Get system info', 'Get crontab deamon process', ""Get logged user's activity"", 'Get system info', 'Get CPU counts', 'Get running processes', 'Get system info', 'Get system info', 'Get current username', 'Get CPU model', 'Get file system size']",1,0,0,1,['09a769882e9a']
d+cN!TO]C@*Cc<CCMK,0,"['Lock SSH directory', 'Save SSH key', 'Get CPU counts', 'change password', 'Remove security features', 'Get CPU info', 'Get memery info', 'Get where ls is', 'Get system info', 'Get crontab deamon process', ""Get logged user's activity"", 'Get system info', 'Get CPU counts', 'Get running processes', 'Get system info', 'Get system info', 'Get current username', 'Get CPU model']",0,0,1,1,['a1d7494470e2']
d+cNZN@*Cc<CCK9,0,"['Lock SSH directory', 'Save SSH key', 'Get CPU counts', 'change password', 'password prompt', 'change password', 'Get crontab deamon process', ""Get logged user's activity"", 'Get system info', 'Get CPU counts', 'Get running processes', 'Get system info', 'Get system info', 'Get CPU model', 'Get file system size']",1,0,0,1,['97043f065f67']
d+cNZN@*Cc<CCMK9,0,"['Lock SSH directory', 'Save SSH key', 'Get CPU counts', 'change password', 'password prompt', 'change password', 'Get crontab deamon process', ""Get logged user's activity"", 'Get system info', 'Get CPU counts', 'Get running processes', 'Get system info', 'Get system info', 'Get current username', 'Get CPU model', 'Get file system size']",1,0,0,1,['8c800215e97a']
d+cNZNTO]C@*Cc<,0,"['Lock SSH directory', 'Save SSH key', 'Get CPU counts', 'change password', 'password prompt', 'change password', 'Get CPU info', 'Get memery info', 'Get where ls is', 'Get system info', 'Get crontab deamon process', ""Get logged user's activity"", 'Get system info', 'Get CPU counts', 'Get running processes']",1,0,5,6,"['6c72c4639457', '7939469d99bb', 'b64b3c76eace', '412256719694', 'f040bff368f2', 'b495536bee3d']"
d+cN!TO]C@*,0,"['Lock SSH directory', 'Save SSH key', 'Get CPU counts', 'change password', 'Remove security features', 'Get CPU info', 'Get memery info', 'Get where ls is', 'Get system info', 'Get crontab deamon process', ""Get logged user's activity""]",1,0,0,1,['e25f488974eb']
+cN!TO]C@*Cc<CCMK9,0,"['Save SSH key', 'Get CPU counts', 'change password', 'Remove security features', 'Get CPU info', 'Get memery info', 'Get where ls is', 'Get system info', 'Get crontab deamon process', ""Get logged user's activity"", 'Get system info', 'Get CPU counts', 'Get running processes', 'Get system info', 'Get system info', 'Get current username', 'Get CPU model', 'Get file system size']",1,0,0,1,['abc92e2d05d7']
d+cN!TO]C@*Cc<C,0,"['Lock SSH directory', 'Save SSH key', 'Get CPU counts', 'change password', 'Remove security features', 'Get CPU info', 'Get memery info', 'Get where ls is', 'Get system info', 'Get crontab deamon process', ""Get logged user's activity"", 'Get system info', 'Get CPU counts', 'Get running processes', 'Get system info']",0,0,1,1,['1c48ee2740f5']
d+cNZNTO]C@*C,0,"['Lock SSH directory', 'Save SSH key', 'Get CPU counts', 'change password', 'password prompt', 'change password', 'Get CPU info', 'Get memery info', 'Get where ls is', 'Get system info', 'Get crontab deamon process', ""Get logged user's activity"", 'Get system info']",2,1,9,12,"['fd65815419fd', '3e0b866e8608', '82910cde0bd1', '73ce14ddd1a9', '6a6c52b61fb3', '337a6ff37c69', 'd2b0cb8bce31', '0f7e71b318c7', 'bec2fb655c0d', '121f301c3acd', 'c97235e5b7e2', 'f97b0593026a']"
d+cN,0,"['Lock SSH directory', 'Save SSH key', 'Get CPU counts', 'change password']",1,0,0,1,['59892e0d79a3']
d+cN!T,0,"['Lock SSH directory', 'Save SSH key', 'Get CPU counts', 'change password', 'Remove security features', 'Get CPU info']",1,0,1,2,"['568b684ff02b', '3a7882741182']"
d+cNZ,0,"['Lock SSH directory', 'Save SSH key', 'Get CPU counts', 'change password', 'password prompt']",0,1,8,9,"['5959f94a8da7', '7d87e4cb5a15', '22dfe750e641', 'dba1fa96b15f', 'cad0e6749d21', 'a021daff40d9', 'ae546f4b929f', 'fe09a7124480', '38f789036659']"
d+cN!TO,0,"['Lock SSH directory', 'Save SSH key', 'Get CPU counts', 'change password', 'Remove security features', 'Get CPU info', 'Get memery info']",0,0,1,1,['867bca88fec6']
d+cNZNTO,0,"['Lock SSH directory', 'Save SSH key', 'Get CPU counts', 'change password', 'password prompt', 'change password', 'Get CPU info', 'Get memery info']",2,0,13,15,"['c5c8a2bed3c4', '6bdbcd892706', '31521a6305a6', '94c3a9c30ad8', '9d5d1f19bbcc', '09ddf5a23cd3', 'de175531668d', '75985197e084', '8370005ecd92', '0d5a4ba86fca', '0013f8ab3fa6', 'd5ce117c7d71', '75dfbf4ae3ea', '2936a88f4440', '445c52a44ade']"
#NAME?,0,"['Save SSH key', 'Get CPU counts', 'change password', 'password prompt', 'Get memery info']",1,0,0,1,['4260849937c8']
d+cNZNT,0,"['Lock SSH directory', 'Save SSH key', 'Get CPU counts', 'change password', 'password prompt', 'change password', 'Get CPU info']",1,0,7,8,"['5b525ec76b2f', 'c14eed4cdcad', '09a86704bf3b', 'ac7737d74384', 'b41ce34adfb2', '5e3e69624a70', 'bfc5c2b39d06', '2f35677c5938']"
d+cN!,0,"['Lock SSH directory', 'Save SSH key', 'Get CPU counts', 'change password', 'Remove security features']",0,0,1,1,['31d1d4f10d09']
d+cNZN,0,"['Lock SSH directory', 'Save SSH key', 'Get CPU counts', 'change password', 'password prompt', 'change password']",1,0,12,13,"['927a4a8df224', '6d19da73482d', '65d66817adb6', 'a340bae1466a', '0d65f5cd9e07', '6ebac1ea22c7', '434f63b1ec1d', 'f213b033357a', 'd0a05cc360bd', 'f98ae5a9891b', '2e30e05b76dd', '68f9905cada1', '1d2d752da410']"
d+c,0,"['Lock SSH directory', 'Save SSH key', 'Get CPU counts']",4,0,11,15,"['0f451477ebfe', '083876a20661', '56ea257586ea', '6f6110555bf6', 'f3e28dd07437', '42fb0d4808ff', '0afd3f44d37f', 'ecf5555905c2', 'fd444d948954', 'c83be4108d08', 'c2f749854f45', 'ed5148dabec4', '06d1b2ad9657', '0974d2693435', '6a9c418a842d']"
d+,0,"['Lock SSH directory', 'Save SSH key']",627,678,109,1414,"['ab25b9169f41', '2b1abffeba8e', 'd1f413786f94', '9f552f954ebf', 'f4e4cebce68c', '81c0505e88c4', 'e4963e9b4309', '5c3231cf3154', 'e2e21a4c3829', '64094f362313', '90e05a3e605f', '4048c6b3759b', '2858840a8cef', '52d008c11086', '88d0641857eb', 'c94c932d9208', '07802f43b54e', 'aa63fe44660f', 'e7231063ac18', '940b69586556', 'b2e328880dc7', 'a5b05bedef7f', 'ac45a2a6b597', '0c3eaccced25', '73346cf4e154', '349cee0678d4', '8b2009158c64', 'dee605817515', '790ef3d2fcfa', '6b7da738fbaa', '50fb67752955', '29b600bdebd4', '57a71651e46f', '066130bc0e00', '3883f84c22a1', 'cff6b790cf98', 'f1fcfabe4ad5', 'ed1c1c513d1c', '14b927526ac7', '10dad4bd2c91', '1b3eb636a85a', 'c11bbb8fc6e9', 'c50bef15b2e4', 'cd8072075cbd', 'b64915748c40', 'f229220386a7', '8a3b69b6b251', '83c39eb4b616', '9de3110836f9', 'dd88235a412e', '4f2c91c130e5', 'a424e3e82f16', 'c433ac40f966', '072af273461e', 'e182d84af294', '7280af32ae46', 'b69f1729a790', 'e34e6a0d516f', '6aa3932291f5', '70c9173606fe', '735eb8f032bd', '294fa05ca7b5', '2f59f78a3d0c', 'f03468d12b27', 'd1c7a71905b0', '904ac67f2fcb', '8912b3122a67', '6bbe7dbb3742', '81185b894dcb', '64308d4f48c0', '8f2d560d7984', '934fb6ae1e81', '3d49380c9d94', '398759a2008f', 'ff3d2476e19d', 'b030149e45e9', 'a9147bc6ca19', '9447151e0e81', '4e8b59cfc5a7', 'd9ae499a2e75', '64c514bf98f3', '2bba4ff96480', '253311e9d4d4', '10bb8a4f8d5d', 'dc387909ccf0', 'a95183a8e9a6', 'b4c253dda5ab', '61056395c3d9', 'cea2721387ee', 'd1f068114655', 'aa5b6f2065ac', '64ab526e6560', '9dbb0aba0c66', '23198c26b3ee', '02e68af66478', 'b12a6183c7df', '0ce1a0445fd3', '5fe5bc8a4715', '00bebb7bb80b', '345a31bdcc19', '93a247031cd6', 'e2e7cb7471f5', 'f5485aa217b2', 'e76443a60602', '921c3101d3f0', '23823d740590', '763de771d996', 'f4f49cf2418a', 'c2577257c8cd', 'b6d33311253b', '665a7f573cf9', '7308d8efeec9', 'be75d1b5c84b', 'dddc57784468', '066c1fc7cf42', '029ac33d00c0', '3d28e0e121d3', '20116f05878d', '00a5b55ddd55', 'cd99580fcdca', '47055acf8857', 'eac735b0c53c', '81cc681df582', 'e2667f13764f', '07277fb0757a', 'b21f876a82d5', 'aaf285841baf', 'fe5bf7c59aaa', '6538bbe8fc3a', '9142e68dcb58', '8d47e2dbc4b7', '7b5174b9f48e', '6e40c67f594e', '96698868bfc6', 'f7d7a065878d', 'acfe36c07a02', 'dbc431f290f6', '78ac5a295779', '391ab18846ec', '735fc7eed6b2', 'c2f8cc5e2fd7', '2a272dcbee7f', '784d47278d46', '5e47d4739272', '0c561872a515', '51e8c56324ef', '6115dd713c40', 'ef7dfb15748f', '5d07048861b3', 'ca01dff0a7be', '56834b8eb1fc', '28a87b00fb6e', 'a2f198eb566b', '65ea7896852a', '8f71b9d62cde', '1ef5f98011c7', 'b54d77167a4c', 'b0691dcf1f9b', '7c9080160220', '745dc762701a', '40bd7e9a2939', '2342ff13fb18', '9df91be55770', '1e663461efd1', '04dd9db1f783', 'cd5f31591af8', 'ede4017e7b62', '8128d1b2a9a6', '1fef69b38e0f', 'e091877244df', '1abf603068b2', '49fba10fc4d6', '6029b05e3695', 'e3e1dc9eaa65', '7a8da63ee7c2', '95de621ae4e6', 'd95cb8a4079e', '935a1f58f4c5', 'bb1eb5c47b2b', 'd99295abc9ea', '259fd3f8b86f', '8dda036ce280', '32f849da5694', '511bbf6ba4f5', '7e34f436508a', 'e58bce524b69', '517b53a21cf9', '3c018cd1510c', 'b81bd771d342', '0c02f0915416', 'e31da640881b', '7cc1469134d0', '8e2c3f2adc05', '2bc2b3e68713', '456590b317e8', 'e44d8015976b', '25bac0f5af20', 'f07ff7b8e0f8', 'f6e96cf0b6b0', 'b4c2fd11212d', '189fe3c74989', '388677ccc1b8', '81859263b528', 'bea2c7c33968', 'ea1bddb1a99e', '73dcbf2a134c', 'dd3efde1d12b', 'ca88c4b39b64', '3618c2488351', '78f54134c8d1', '2d7c5aeeec9e', 'b8804f2eff5a', 'eae85f83fed3', '14c11472ee3d', 'd1ec782c9507', '029fad8adb9a', '79c4f06d93ae', 'cfbcdcc61896', '0f7f6b86372d', '49dd46e12f83', '270563da56e9', 'c4a2be060359', '887e50f75ec6', 'df79536ef36c', '3eb792a7c0a3', '8cb426ed3597', '00cfefefa33e', '8ced80c23eb9', '5cb3b6d87fed', '5e21d7888791', '2ee824b32d0c', '08a561b18bf4', '92ff6415d420', 'a7d8eab8e67a', 'daeb4669a714', '977f84f0bc26', '0cad26dc631f', '0aea822d5e9e', '5d04449a37c3', 'daeebab6a270', '86fc69e96505', '412d5bced745', '4cdf9a6fa773', '139ecd7f78a7', 'f7249869327b', '8731c9e1c93d', 'd3bbe77f8401', '7b66dcd0dedc', 'f91364e1e939', 'e65ddeacae3f', '01b318be891c', '738660dc0602', '1e4ac484321d', '4abde1af2f4e', '57d12f27cfac', 'f680b8e03f4d', 'd4dd5b9e19ea', '3406802da80b', '23f7b6fdd654', '680663af02a1', '3f7d1ef4332b', 'dd53bab140e0', '5c14c7beae97', 'd6bb1d4f6267', '28382c40b177', 'e821b491a309', '7b5c9f0f1a3d', '8ce7ff789d5c', '0d1acdced060', '0a9fc8a45d58', '0539eb90c640', 'bb3e746fe397', '7638cfe5affd', '8bff247d4534', '4d4ba32f119e', 'ad9efbc16c99', '425462363fce', '68a793605a07', 'f43903079dbd', '6f95bec59f72', '5be4dbd42646', 'dbfbc094b1d2', 'e38494e075b2', '62b5b166fa3f', 'a77157a74639', '617a1917d6dd', 'c0aa4cd7cd8a', 'eb976725ead2', 'f160465d26e3', 'c20ac417ef05', 'd291aef63c7e', 'a3d49612cfb8', 'e7a162b99c84', 'e5de14bd2436', '94a4ae9c7279', '02770741b631', 'db98a4d36fcf', 'f0013b92d08c', 'f17885377117', '5595f2207bf6', 'cf824e0901c5', 'c6e5c2216b22', 'c5715ad7c21c', '281469998361', '7b36ddd92dcf', 'b0f6dfcaa9aa', 'a5e87eede000', 'd70437599628', '15690de9f771', '7c1e53d26ea4', 'd093cfdd141f', 'b81a85096849', 'a16e3fce8181', '5eba906326e2', 'e509ca2d224b', '1112cd82a29d', '9f8c1380875c', 'fdbad4efd3f9', '28ec482ce186', '70e68a72e528', 'da6099d4a84e', 'd2e9bc2f2d62', '9ea989e0a661', '5bb7dbc17b12', '92eaabcf68c9', '37f7871321b2', 'f539b839198e', '7f6ac659a1c9', 'a8eb8f413ccc', '4e5c97b13717', 'a74e023bc37f', 'e30b32daf1b4', '9ee885b859d5', 'f2098a67f597', 'ddd1eb04833b', '63fd230e5c6a', 'b238609235af', 'a8a87bec0f07', 'd2f1dfb11a6d', 'e2d91511f17b', '37d3fee9f46c', '5ae8241addf0', '904c9cececec', '29b1337c2dc0', '8d4f4b753d98', '247dd2a445a0', 'fb106bab3bf6', '5ad9725013ea', '2b101d20ee2b', 'f36cd09f256f', '40a6b9c8aef3', '498a52e457ab', '559626166733', 'a2701280e963', 'fca6236cfcf9', '24b604bc1fc7', '28c5739cb08c', '02560ca66da3', 'd51b0783259e', '9edb82b0824e', '0f079201a155', '3d3606735edf', '954a98ad45c0', 'daed718d253e', '670411ac613e', '8a0f4bf9de15', 'e6b8f0b5361b', '543d443466fd', '4b5a44302ca9', 'bf4642c24290', '5dea2b8b4779', '4689fe132f55', '4e0ad5f7d2e3', 'c563d6be053d', '37093b6cebf1', 'c87818f1cde3', 'b2edbc63f968', '5f77142d4e34', 'ffc4a4cb798b', '0a9ac3c47b93', '75499712c08a', 'fd807592fbfa', '7319593ff5c1', 'c3a75b056fdb', '802b14d52cd1', '8e222b9360cb', '8cf4c4e4165c', '6e119ed2de4a', '3a4f7dfb226c', '5078aa1ba8c3', '332c9c0958fa', '79b640ca4584', 'd5be76ec0a46', '53d9468910e6', '4aace3cd976d', '54741b52bd2d', '6973a8bf1698', '044ecb1dc827', '4c2983bb4ec3', 'eb949b358810', '7c486bb3cb39', '948110ed5029', '4cb38dab7f9b', '3c200b72a862', 'b4a799a713ae', '69cb04d12bf2', '3b0d4c76a584', '357c5241fc6a', '19aae5a1f821', '4566557c86d2', '4044ee010568', 'f9e015c25247', '2121b6c91031', '4aceea349362', 'df7821d57e19', '052eb5c22d2a', 'ac08a49c2ae5', '5b0bae8918d7', '674916196fb5', 'e743a63c0b23', '4d2877a4a6e3', '74389b1bfa66', '7f2d66957702', '5504393885c0', '9fc568fe558e', '06818b0d5390', 'c7ba81419861', '55eabb3058ef', '8a0aa2334630', '8d193d75830e', 'd1b1ee704c1f', '54ed437d3f02', '0aa16eaa56fa', 'c695529f2d76', '27dee2833a27', 'ffa15f7473ba', 'f0d949d87946', 'e1d115ceeeb0', '49cdda70adcb', '7a3a8521434e', 'fca042101cd0', '8438c7e7ebe5', 'f73bacab9108', '40a9ec4cd912', '5f1e0415223d', '9b26a8795a41', '6968535ce9e9', '530ed15b96e3', 'ae65389fdac5', '873a6c95ae92', '813ad2327e3a', '6202986d5980', '85d7cb7de6b1', '9d4b2bfd29ac', '88b12d8b7349', 'ce8662fba3e9', '6bc7ff8efecd', '3afef4c5cb80', '7f2406764852', 'b34476c52a62', '40bdabc8e998', '41d03ff058d5', '210a03b5d791', '82542da3fc61', '3445600b691d', 'ad7359780951', '2de26f62b618', '4f7791db3036', '7893e64bb5fd', '74355a3d4575', '4e0504c1828b', '03ad28a50c16', '51127e6a22d9', '6d43fb075780', '1edfd6b88e50', '1a8397d3ca2e', '69b4b0d1dbf4', '2d94803e733c', 'fea760a5316d', '634a5b9710e4', '3bc2e16d2be2', '2555131bc8c4', '1b55a20a2534', '195a6930e651', '90c6d3208bae', '3b4f1673939f', 'a835ce059623', '4f8ce3e3ef56', 'fe519256fd04', '9efe89035683', '9270f1a00d43', 'b5d5549ed442', 'f3775841c914', '72c787283ca9', '831ef5507e3e', 'fd9b51c7a288', '8b33eafb77bc', 'd3cc6b9331ce', 'b5548290015d', '06f39a65854f', '914494e875df', 'e0aa8b0a7fa3', '8998522d62b5', 'e8b4a0f62318', '507cbf0867c4', 'b369f9f4dd66', '8a9c15da902b', 'acfbd98e0431', '6fc4f40314da', '019848a55d9d', '36ccbabd8a5e', '804d5a7549d9', '022224d4c642', 'a80cbe2fac84', '20ab53d10202', '359799ac0350', '60a363a4e20e', '0a22bcd30be9', 'd8ce4cdc44fc', '1421ea3a31d1', '3acdbd0e3e24', '602878050170', '5c881ebfe01e', '3caade14f46c', '11e36af7b4dd', '2d289e323c8b', '06352b7ebdc1', '6c1b4b28b793', '4e403959ab8d', '0c2374f2d087', '5df54989111e', '3e8b8ff8f064', '28bbe19abaff', '35fcf05e0b3f', '547d079e2e6f', '2b03eaacf416', '0ceb7aa575cb', '143094236ab2', '1c7ca3ea3f94', 'e6604b307c41', 'ff4ee91e6b24', '54a1a6e1729d', 'c19fd03488aa', '51484d285f7b', '4741ac8415ca', '84c03eb612d7', '665d87cffd12', '6add38960200', '15ed6a83afa1', 'e1b0f92e9e09', '47e5088065ba', 'a9a9d2110624', '309dfbe67521', '412a74246c0e', '823aadc5468d', '41476324d2f0', '2633398ef605', 'a1dd4886a71c', '3701631ad213', 'c1fe8b0fea02', '56698e4abfc5', '555fab97cd0a', '6f35a800ccf1', '897fed998b2c', '9db3b08f08e2', '15b978b60ab5', '16abf0f4c472', 'a84b9f0f14b7', '57fdb4a03b04', 'bf3cc75d1b7e', 'fcd95e5c7b64', '49bfe59e9b4a', '6d50db19e33b', 'b449ce86a094', '55619709c205', 'fb478f062490', 'eecbc8d0821e', '786bcc294d11', 'c372ed9ced0b', 'fc730302f64a', '86d0b79dd661', '2cad5aa82d11', '85eb4f5b9b57', '79af08217403', 'f847c49c026b', 'e884b85b0add', '4211e5f83cec', 'ca2b3b1d2517', '387e5df73080', 'b55421b08aab', '7e88721ef4e4', '050cd60c84cd', 'f09ca01674cb', '37266c3296fb', '7302f7a8a262', '3891921e0bef', 'fe40d9f6a5a6', '73859b58e377', '698f9d89c01c', 'c14272ee6700', 'd7ed60940a85', '741e20148182', '39a85081899b', '86eee48593e0', 'a01a8ff223c0', '54672ce5ee8c', '929e2f6bd4d0', 'a069f2499379', '2acce3d08dbb', '2084ff7dbc32', '869c90ab4617', 'a1657e6114f5', '0a88fbbd5357', 'da9caed82a01', 'd99454f9bec2', '410b073e76a2', '0a6fa299b2ba', '003c6cddac38', '6b8a5be89a17', '8ec7c6c14e9d', '2b75fdf87245', 'bfa5e73209f3', 'd1992960191e', '219ad9a80631', 'ad705a3ce049', '1ed034985ed5', 'd99f4e1747d6', '6daafbfb0328', 'c0f8283bab29', '4c6207d4f727', '77d1a741a1e8', '208355f86c01', 'ed4e18855b1f', 'ea7abf9bb70f', 'f22899a49234', '8064f58a1909', 'c9fc9d66f0e5', 'c3354b8d61ad', '1e1d0311b60d', '7860fa3c6901', 'a9c8b4c37536', '2979c76059c6', 'cd464802b639', '3240f9eba7df', '4ab9e7c20c39', 'a7eea5660015', 'a77ba2c0ac8e', '9189067fd7dc', 'faa9490999f4', '3a5beea31f20', '555e15d3b604', '6eb59f906b7b', '2d312c5bde2f', 'c7a5e2ea43bd', '3f95ff992114', '93968914df49', 'c311f522b3c0', '0b814a7a7115', 'ede62c602eaf', '71b46cbdd3af', '9d17a1ca1415', '6304248b6f23', '8cf266f5836b', '3729a9591165', 'e3acb16c7c87', 'd2c8f1115077', 'c132b81aee56', 'fac261b40c25', 'b67ee61f9087', '07f11ee81f4a', 'b6cbcad69a94', '61ba26c2fb6f', '535227cf8666', '110d495c8808', 'a73ad52443ec', '74c80e08b0ed', 'eef411953f22', '5f9b5e131ada', '55ec87f5c167', 'ddba6bff4b90', 'c56ab025256c', '1a525bff7810', '7792fa596ae0', 'c312b5f25317', 'c3a262f72936', '8bf518d2ea0f', 'e01a7f5b833a', '5608e826e4f3', 'd5eecac4733c', 'd7f6350f7522', 'd96cb9eac594', '3075e37df24b', '918d9b26e760', 'dd62f071f181', '042d1e2fe0db', '3d45e6a0ff65', 'eb04e46e2580', 'd4e28cd81996', 'aea43f390a6a', '9819f270014d', '1d8c1445e8a5', '62260c7e95e7', '5de3a8c2e3e3', '9b877ccfa05a', '7fdc46466c3e', '97dd349d2817', '80a854689b43', '73e27955e459', '73e05ff68e0f', '0e4f3232750f', 'df75621a786b', '24b88cf6bf9e', 'b5fee0acbfc2', '194d99df00c3', '6313b4d648eb', '0d6a02d2a01c', '7c65cf4d60fb', '4269e3ea19d3', 'a512e8291590', 'da7bcc1bfe80', 'bc2dedd1fb66', 'bc6b94711eb2', '414215fc05a8', '7d1ba5a27dd5', 'b66f0e97e0ce', '60c8432da05b', '203f82d5162d', 'd48f8b97eb85', 'e4377076966f', 'f44fb941c492', '5ea927a962e1', '6c2d63b4acbc', '3aafca5d336b', 'b6f48f47847f', 'c2fc962194a4', '940bf2910aa8', 'd1388deb24b2', '69b54f480802', '9faadb8a4fe0', '08529bbc1478', 'dbfd88eb63ab', '100b0169a832', '3d982d1f2d03', '5052deb44ca5', '2ac4fd860523', '6edb9fb58b7b', 'da2059f567cf', '03ad88f0861d', '6b43dbf10e1c', '7d362a8c52b3', 'befcbb4b3a92', '942ef4c33480', '44a60b3680c4', '5a83a73ca3f3', '862d7957e7c9', 'c3bd9211a34f', '595cc2c9c072', 'd01c7be5e800', 'e3defbb77342', '2244d29d74c8', '3709be604a80', '421656cd751e', 'ccb8828cccf9', '5c661d16baee', '88711ba993ca', '33518ba96c86', 'c54253becaf8', '0250332c813f', '238ba9e9ca62', 'ebb7e6057d88', 'd1f1b8fdef66', '2d6ceade0895', 'c749435afec3', '34b9c4feb235', '8728453c4666', 'ba114596952c', 'fe9969caf24a', '19d13b489e7c', '5d54f1cd5940', 'b797d7c6adba', 'c6b9e0f64e8f', '60e32f2344ad', '0757026aa530', '349243bd26af', '0aa85fe74ad9', 'a07db8b4319f', 'c3abd77fab97', '0109f5c8931d', '38bb3756a74f', 'f9d0e7bec5ee', '5607bfc2914a', '042cf515755d', 'e8898950a6ef', 'd7e29b3c9b96', 'a1b8e89a2e58', 'b56617024bbe', '93a6d8a26470', 'ef82e78d4c01', '027d43a999db', '0d278fbb13ab', '01cf84122e62', '502c533a9947', 'b9891053caf1', '16e37e565066', '88f83d76eada', '1ed4cf905203', 'f21f845980d8', '1b2aced0a5fb', 'c356d31cbdb8', '83bfb507826b', '9bb194830141', '1a9271caccea', 'd647ea636f13', '67cfd6f88fbc', 'cc0e2fe830a8', 'a7df1fbb7ea4', '67f8030242d6', '39afd9482aa6', 'd8dc8ea5b56c', 'c06e0bddad7a', '5dbbeac724be', '00306a4a626a', 'fe38abc633c3', '7a5059bcf5fb', '326757c86cf3', '83cf3c0a899d', '41292cbdbd95', '7ced248345b6', '4577d306e489', '505cb132f8c8', '11f3dec6fa76', '89ae0ea91d47', 'f80136e35eaf', 'dc506f25487a', '63139df8c4be', '4297f3bdda32', 'e7e2c6582267', 'db36c5d009e9', '2792870f0a94', '3d26aa940f12', 'cbf71eedd5c2', 'df0bbefc66b2', 'a929926c633c', '55ccb0b65674', '850c7039aa42', '5f880b981995', 'd81358a7fd75', 'a5fa02cbe7c9', '1f483be1d8ea', 'f579711c4317', '7982a24128d2', 'b50d761ceb0d', '040fa90f5048', '162a2ba0edbd', '39a3581d1ec4', 'c796890be0bd', 'ff99d8232e1d', '5857aa1efdb3', 'e7989e29d42f', '219a46ea5ac0', 'ec1e252e0f0f', '5bbc076db0d9', '2686c21ad513', '76b858535c8f', 'f04048e68d79', '544b9105908e', '7ad35be66c61', '6d8d0b6708f6', 'f8a016b49fe1', 'bc9ba77aa7b4', 'eb34714a6bdb', '67fffb5523e3', '38af0e139adf', '13b3fb16d655', '835a8bdb6b8a', '1724c91dd4eb', '05bcf09dabec', 'f245ee177cb9', '51bd50d2da5a', '47c5c1373b43', '2f83e7a0f930', '9d95fe19dd2f', '750fa04ee126', '4c25fd6c31cd', 'b108836b7eea', 'ceb62d5cbbe6', '3d56a856530a', 'cd146f12193c', '57bd9e49b747', '0da09e56e1b6', 'f38299cdfa4b', '31caddb3834e', '7c77ebaf6c8d', 'f0d3559be2a8', 'fe8a041e0d54', '0409ace4d6ef', 'aff39336ca7c', '4d942b43106f', '096825efab9e', 'f3f2f3d0bb89', 'ffcbbad84f84', '39e0b7bfe28a', 'af9667eec570', '7c32f202e3cb', '9b1b95fc400d', '5bcb9d5842a2', 'e1ad71f664df', 'b6002a1c18bc', '53c04dd89df8', 'b0916185473b', '62cc347bb485', '8bee7fbfbde4', '1a71517f443b', '9e44a9f26835', '3f7a80fe4b89', '85af23534107', 'afe60c727851', 'dd4e7c832ba6', '9f2515234ce9', 'c05e9b3f5652', '536e82d861fd', '18b9e5026560', '68d326efefb8', '1009e24622d2', 'a83156cc3817', '85c53b75625f', '5b1d816fa7fc', '36eabeb63bb6', '4fd28d24feaa', '999ee5f703a9', '8826a85938af', '3f001383785e', 'cf9977368644', '981169109c7c', '192d2fb93230', 'c2bce8797b33', '42b64aeab1ee', 'd337813fbccb', '4755a6cb8121', '6fc97c43af95', 'b8e20d20c5a8', '541f712c25b2', 'ef83b42ee09b', '20b3b0a1a209', '7be06aa67efb', 'a63a000b527c', 'b326e2c58aad', '1223009a56f6', '927af04f4058', '9427dba32c4d', '46a0f7926b03', '72c876f6e430', 'a837238c6621', '912c681c7366', '55f2ba1bee96', 'b262c85649dd', 'fd5e56211979', 'f8cb13b8b731', '6877865e8f75', '4a2426f0571b', 'c5a8c2eec752', 'decbf2fe4940', '4e3e6fe7775d', '118d8b7fff81', 'c253961dfc4f', '852dd771e4b3', 'c3cc2075e7f8', 'b6f41e15b070', 'fa3bf0602e52', '9896a8c2acbd', 'bb34b8cc07d3', '028e2b2b0187', '8d1b80c27492', 'ca2bc0200a30', '14241a58e1cc', '0cbfc1bebfb1', 'c10d30a7b9a7', '06e095c83ad7', 'c1e55e0fc62d', '99a00668b2bd', 'd769f7d2463c', '36a82fec5fdc', 'acc7a2c256e5', 'badbade24d7f', '1df10e65b65e', '16206e614553', 'f7483b85f468', 'b0dd988bbe5e', '9b16c70cf6e2', '22610bf49e6a', '2e7de35a064f', '0c8ec1641ce0', 'df9e0e57237b', 'af759a2397d5', '89fdd9e2a03d', '9f9497ee38e6', '946204241754', '327d4df8d685', 'b2ceb1d1851a', '9094d9cd0daa', '39f6acd1700c', '49f5ebaf2847', '41156e35923f', 'e47f98f69189', '37cb1a1f1730', '0f76a9b3505f', '85844491d2f1', '0b353e4ced9c', 'aaf90e21ac77', '16a7da45ae68', '46e1749c9347', '08736a291ed5', '9148e636d3d4', '391662321ce3', '728c02eedf33', '4b7308213291', 'c8a8822a2be5', '1729f4c2384f', 'c43dd9e7587d', '45143aca4bb3', '51abb50d19e8', 'a489243e3e1f', '775aec269003', '1fe0eb330894', 'b7e8f8275deb', 'b07acf21902c', 'ecbafe42868d', '8d81aca65ab4', 'a48804b87fd4', '3c5f74cd260a', '6a7f31750e7d', '0390b3acc1de', '26e8924f232c', '842930caae5e', '84759ed03b69', '695f91d0915c', '6a5fd42b507a', 'aee32008422f', '3c5d47ae33ec', '4ef1592ff4cb', 'b2dd65a0c3b3', '1b33325aa556', 'fe6737f7c7ff', '4641d0a57ba4', '25e43e931fb1', 'eae968d7b200', '3e289b8ad6ee', 'c9ac04698141', 'f556edf6415e', '9aa132a9e63a', 'ba442191ddf2', '2517f293a293', 'cadfd9ce0f02', '43ab9d4653c4', '30c7ce65d6ca', 'bd138d357595', '267d2d2a8ee0', 'e0df64c8a57e', '4b253d7b99da', 'd43d14b083fe', 'fd2a928182ff', '0e6cc753a935', '5ebbde9dcb2e', '337fd2248335', '148625194f8b', '0626b88551b5', '4b122e208db4', '84b498eb5131', '0f5a314a5f78', 'a6a8fa2fec3d', '757c7f35924e', '6e055708c93d', '21334938bde7', '1cf779938e26', '1a9acf5fbd1f', '3e7e780cf037', '111bc94a3127', '3442f4e1313f', '7c068fdeb48b', '374158963cc8', '0cb877e930d2', 'c06297183de9', '9e022e509f25', 'a179e0726b68', '79183db9aca4', 'b2321ba406fd', '1b742a5141b8', '77686d5dc068', '574db6d8b424', '7c1f1d9a8eca', '867522e2400b', '9ea5564be3ea', 'd499afb38b6c', '4f46b7d15b43', 'a7d3104284d8', 'ce781ffa186d', '3c7b38f6d1f6', '49f42349b25d', 'c8b77669a565', '6232431d268f', '1afd5e254202', '3000715e3f4d', '6272232e070c', '9a1029286e9e', '309dd7b913c4', '604511f9de79', '71076b5f17ad', 'a4ec3696a962', 'f831ad62eae5', '21a86a324813', 'db973baabcbd', 'ac62a34984c0', 'e8a834b081cf', 'b766749af4ba', '265c1735ae04', '285e5f3c87d7', '7fc639afe458', 'b9d6af46df2d', 'afca0e0a8449', '861adaab6dcc', '8e9c231b7e85', '11586e59b98e', '1f568ee1516d', 'c4424c04035f', '503a90d9fe8a', '4d5c262f64ab', '008a281908f8', '0eba56714d55', 'd0cdb93dd2bb', '5dfd96a43d93', '5d804070420f', '385682f395ad', '20ec3ae79b8c', '7586d12d5a6b', 'fb79ee4d8fc5', '863ff1497d09', '9e402ea3354e', '1f6c299b61d3', '657ec1f2cb3b', '320393b2ad45', 'dcf2e9edc10c', '621cfe03fdc0', 'de9f6f58797e', '899d0f8cf2a2', 'c4ed58e8fff0', '94e5c026a3f5', '669ff1f7f04b', 'ed8c8327136a', '94b4e724eb8a', 'd1c4d9ff909f', 'bb0462dec14f', '94773d06034c', '5306d284205f', '3a2f765b2ce5', '938fba2a4672', 'eb985d1c1b62', '29aa9c7e811b', '957babbec561', '50de9f1cc44b', 'cb0687751992', '72ee0f3a6b02', '2303d13f6cb9', '2eeb2ea8112b', '41428c892bd8', 'c7dddffdb17c', 'bad0d6c10a6b', 'd0f1811a4166', '21eec0ca3b64', '4dabade50a3e', 'f5831d07f5a4', 'ed18e7793b45', 'b4630afee459', '155c405dbc23', '90f00f00b8fc', '9d85a7c0d9b2', '93cb7250e78a', 'ed8f779d9d31', '8cceb4834ff5', '477b3c8a3080', '357940d7c3fc', '7a8c7e74017a', '6e09233a713a', '20015b3a3da4', '41ecfc437747', '2897a68017be', 'a61de0575a00', '251318541d81', '968d7104a16d', 'c82e5a995444', '5cd277b24bc3', 'ea94ec4fa224', '7e872d924932', '6ab2753faff6', '6db01c0efe41', '85b4c9b6e7c5', 'e59d25edd7ef', 'b22307e203d3', 'b0f2ad939e31', '4919f22ad5d0', 'c3d87b18e005', '6b8c436a3dab', '09c3d8c0da69', '9a1525186d15', '3a760379fbc0', '12f844521b1d', '71d358023b4d', 'e85d0d596ab0', '07a7a02415d6', '2b563bc8bf8d', 'fb4a1f0326eb', '24b1173bfb5d', '50ab4b9159c5', 'aa7c76749f78', '3d4fa6dff5b4', 'f8bbe97b4f69', '1cdd939568bb', '75737c1ad4f0', '12de426689e2', '6901b769ced1', '9c9f04273b96', '97e8e1e7edc9', 'ffd3e43e011a', 'b26889857799', 'a84682e4db09', '82acfcbc5f37', '78889f744cfa', 'c34db3770eae', 'f1a6c016770f', 'de8d57bf172c', '9e5f14997b60', '220c6a29be24', '54c1790f0ea1', 'a0679c64af52', '126cc4ab119f', '757c1f9a62e3', '4a8422aad4f2', '7b5bc4a947b1', 'ceafecea8dc0', '2bde68cf3b46', '128747d36b28', '526170627b3a', 'c2f022297433', '24ac1580cad7', '2b9e9cad65dd', 'a3c2f1f22e52', 'c7b23ccbcba9', '225b11679837', 'fb3e555ad849', '4a6e134e7ec0', '201714bab467', 'a95aae7c16ad', 'b671ccea8006', 'a830bb2e6f57', 'dca22844a23d', '613c0458e521', 'c7c77df47506', 'f7bd1cd04814', '121ec3922a6f', 'b97e9c442b97', 'e986bd8e6977', '6d52397604c5', '08a3818dd35e', '44a6d56acaab', '79c81c44963a', 'ed3a84a9a39e', 'be4adfb3db1d', '81a6df2b1f60', '8b44273c084c', '98c156200fce', '80dcc4831bc3', 'ad0026f27de8', '7563e08621e8', 'cdaa57fbedd0', 'b2d87bb9cffa', '0fb4a369ef2b', '7783a562645c', '5dc514cadac6', '885eb68552fb', '2c66d47f5cb1', 'e1471f81fb74', 'f5f86f89bc41', '3a0214c28722', '784300a2071e', 'c4091c642beb', '6122834d919c', '9fc4ef92f171', 'c3a570a7dd3a', '5d741d496d58', '93d49b8594b3', '78b7ad3f6c55', '6a7e752037ac', '55a16c157aa1', 'fc084f3d1ef0', '0576ebf36f7e', 'd396530c7974', '3e4c033f8ea7', 'fb7dba955395', 'bcc45564b1a2', 'c51784592287', '2bd5a2a300ba', 'e3df17c424f1', 'f1e73130c15c', 'c58d10d4d448', '559b8f85ea11', 'c36b5e537bc9', '1404bde8bcc0', 'b9795943960c', '1c90c15a81e2', '993eb954f1b8', 'bd7ecf803f79', 'f7771700c2a7', 'a98dd16e83d1', '8e65a000d2d4', 'af28f2a9db5b', 'd4f9307b8f78', 'e2f9df3d6ddc', '0d4b9ed46a65', '0dff52c63a9c', 'a3713ba35951', '3ae417a0ae48', 'a00326e308e7', 'f065707fa425', '719f9fa015c8', 'e7b50d0933e3', '87d0ba6cb0ee', '4c47d521b2e7', '541333de0c25', 'cd3b244195cd', 'fb4248bc1b15', 'b9ac2a66080d', '0fe8677a5c41', '1a5f331c8eef', '95ba33c99924', 'b5b994b7e76d', '5114326f31a2', '8cc3468d53cc', 'd048c3930151', 'e2fe6e8f585a', '5ca89bdaa91c', '2f1b6dd81046', '928c068719b1', '59df7e16b6b1', '5c5d2ab2ccac', '9900c16ecf6c', 'b59c4211f7eb', '20413aa909be', '8a2ac36f39d8', '44d7910c7dea', 'd273b8c07827', '7597171db016', '442262da39b1', 'bc624f4cbb2e', '98db2985d002', 'aae4c8a48cd6', '800a296be26c', 'b61111958c96', '6cc9d2c66534', '7f497fb5ecea', '4ef0cee02d20', '5d9e69195b37', '73ee5d69f752', '74275232bd42', 'a1242efc8676', '8e739f4a794e', 'dc3f258064c5', 'f5c459de17ac', 'dcc640d7d535', 'c5bf5d33b8a3', 'd22cb2196d91', '4b893d13c644', '7faead429620', 'aa00b5dc41ef', 'b4c1887cfd22', 'b3bc921603b5', 'a9072c4324dd', 'f7c948cf2475', '498277462198', '04441cb8be92', '2c49eed6fa1b', '0835bac7c5a8', '7af83d6f9dad', '7619352682a9', 'c901d015499a', '6b73e5bb98d4', '7bfc95130267', '6310a8f3aa77', '8c62db743fcf', '4e2cd73335af', 'e25e308dc091', '920f167a79a5', 'a436159108bd', 'f65b2a4dd8ba', '781092520d57', 'dbe0012e0a5a', '732a1118efa0', 'ad411ee279a7', '359fc8121e55', 'fdec6eedfcbe', 'cb10ad799515', '675159f8176b', '207272efb51c', 'e5c61f696fa5', 'a707ebfb3874', 'c172a89fb6fe', '5e77539df826', '3f51c7159aae', 'aab19e751c94', 'ad650d6f33b8', 'b4382c31649f', '8d2f3fcf5847', 'd22785d09766', '292af6806484', 'f4270118f878', 'af22a1d42022']"
IfF,1,"['download executable, execute, remove, clear history', 'execute', 'Check for gcc.pid']",3,3,0,6,
IF,1,"['download executable, execute, remove, clear history', 'Check for gcc.pid']",0,1,0,1,
"PGLL&RYB,S",3,"['enable shell builtin commands', 'System info', 'spawn new shell', 'spawn new shell', 'Get mounted filesystem, busybox token', 'Copy an executable file to .s', 'Check for tftp and wget, busybox token', 'Read .s file', 'busybox token', 'remove .s, exit']",6,0,1,7,"['17c12bf33c40', '3c615b0f0b75', 'd8731fa29fc6', '5dfc92f7cb50', '7e543ec52241', 'f1c45365a58f', '47601f904506']"
"PGLL&RYB,",3,"['enable shell builtin commands', 'System info', 'spawn new shell', 'spawn new shell', 'Get mounted filesystem, busybox token', 'Copy an executable file to .s', 'Check for tftp and wget, busybox token', 'Read .s file', 'busybox token']",3,0,0,3,"['47e7a248dc23', '4ad57e67e995', '37fe55fed131']"
"PGLL&RYB,0",3,"['enable shell builtin commands', 'System info', 'spawn new shell', 'spawn new shell', 'Get mounted filesystem, busybox token', 'Copy an executable file to .s', 'Check for tftp and wget, busybox token', 'Read .s file', 'busybox token', 'remove .s, tftp to remote host, execute, exit']",0,0,1,1,
PGLL[C,3,"['enable shell builtin commands', 'System info', 'spawn new shell', 'spawn new shell', 'ping and spawn a shell', 'Get system info']",3,0,0,3,"['c14816382cc4', 'a776aad4ebc8', '7262b5587e96', '34cfd8cfda4a', 'f5ce57cefe1f', 'f3abfea524cf', '62d181644c12', '066cf3a1ffad', '134b9bcc1bd0', 'dcc1b9d35747', 'a29d76313d5e', '3b4fe2d8fbc3', '20b8fd35a56c', 'c2646bdc3277', '5c6045d597a6', 'f52918f983d4', '35b650506e19']"
PGLL[H,3,"['enable shell builtin commands', 'System info', 'spawn new shell', 'spawn new shell', 'ping and spawn a shell', 'get system info']",11,0,3,14,
PGLL[,3,"['enable shell builtin commands', 'System info', 'spawn new shell', 'spawn new shell', 'ping and spawn a shell']",24,0,0,24,"['fe520cba34dc', '3b3b23513b46', 'c5a4824182e6', 'f821c0604017', 'd1be9660f4d9', '067247601a4d', 'c75fc5c42b21', '2c793e1251c3', '1be16dd8a49f', 'e0980478ba9f', '5398ae71298d', 'b36f39471a77', 'f3dfe91b87c0', '954c76c92886', '4c901be87638', '648767ec703f', '6fcc1f0c8ace', 'bfc82e20999b', 'd65806bd964f', '58bf2a1af830', 'd2ae01e8501b', '75907d751576', '079087c43fb9', 'b69e884c84e3']"
2>2D,5,"['download executable', 'write executable on the fly', 'download executable', 'broken string']",1,1,0,2,"['324c5e429734', '5b576a8f6281']"
%P:GfLL>,7,"['command: start', 'enable shell builtin commands', 'config terminal', 'System info', 'execute', 'spawn new shell', 'spawn new shell', 'write executable on the fly']",1,0,0,1,
%P:,7,"['command: start', 'enable shell builtin commands', 'config terminal']",1,0,0,1,['100e3f66085c']
%P:GfLL>N;6668>>>>>>>>>>>>>>>>>>>>>>>>>>>>>>>>>>>>>>>>>>>>>>>>>>>>>>>>>>>>>>>>>>>>>>>>>>>>>>>>>>>>>>>>>>>>>>>>>>>>>>>>>>>>>>>>>>>>>>>>>>>>>>>>>>>>>>>>>>>>>>>>>>>>>>>>>>>>>>>>>>>>>>>>>>>>>>>>>>>>>>>>>>>>>>>>>>>>>>>>>>>>>>>>>>>>>>>>>>>>>>>>>>>>>>>>>>>>>>>>>>>>>>>>>>>>>>>>>>>>>>>>>>>>>>>>>>>>>>>>>>>>>>>>>>>>>>>>>>>>>>>>>>>>>>>>>>>>>>>>>>>>>>>>>>>>>>>>>>>>>>>>>>>>>>>>>>>>>>>>>>>>>>>>>>>>>>>>>>>>>>>>>>>>>>>>>>>>>>>>>>>>>>>>>>>>>>>>>>>>>>>>>>>>>>>>>>>>>>>>>>>>>>>>>>>,7,"['command: start', 'enable shell builtin commands', 'config terminal', 'System info', 'execute', 'spawn new shell', 'spawn new shell', 'write executable on the fly', 'change password', 'cd into directory', 'print executable file', 'print executable file', 'print executable file', 'change permissino for a file', 'write executable on the fly', 'write executable on the fly', 'write executable on the fly', 'write executable on the fly', 'write executable on the fly', 'write executable on the fly', 'write executable on the fly', 'write executable on the fly', 'write executable on the fly', 'write executable on the fly', 'write executable on the fly', 'write executable on the fly', 'write executable on the fly', 'write executable on the fly', 'write executable on the fly', 'write executable on the fly', 'write executable on the fly', 'write executable on the fly', 'write executable on the fly', 'write executable on the fly', 'write executable on the fly', 'write executable on the fly', 'write executable on the fly', 'write executable on the fly', 'write executable on the fly', 'write executable on the fly', 'write executable on the fly', 'write executable on the fly', 'write executable on the fly', 'write executable on the fly', 'write executable on the fly', 'write executable on the fly', 'write executable on the fly', 'write executable on the fly', 'write executable on the fly', 'write executable on the fly', 'write executable on the fly', 'write executable on the fly', 'write executable on the fly', 'write executable on the fly', 'write executable on the fly', 'write executable on the fly', 'write executable on the fly', 'write executable on the fly', 'write executable on the fly', 'write executable on the fly', 'write executable on the fly', 'write executable on the fly', 'write executable on the fly', 'write executable on the fly', 'write executable on the fly', 'write executable on the fly', 'write executable on the fly', 'write executable on the fly', 'write executable on the fly', 'write executable on the fly', 'write executable on the fly', 'write executable on the fly', 'write executable on the fly', 'write executable on the fly', 'write executable on the fly', 'write executable on the fly', 'write executable on the fly', 'write executable on the fly', 'write executable on the fly', 'write executable on the fly', 'write executable on the fly', 'write executable on the fly', 'write executable on the fly', 'write executable on the fly', 'write executable on the fly', 'write executable on the fly', 'write executable on the fly', 'write executable on the fly', 'write executable on the fly', 'write executable on the fly', 'write executable on the fly', 'write executable on the fly', 'write executable on the fly', 'write executable on the fly', 'write executable on the fly', 'write executable on the fly', 'write executable on the fly', 'write executable on the fly', 'write executable on the fly', 'write executable on the fly', 'write executable on the fly', 'write executable on the fly', 'write executable on the fly', 'write executable on the fly', 'write executable on the fly', 'write executable on the fly', 'write executable on the fly', 'write executable on the fly', 'write executable on the fly', 'write executable on the fly', 'write executable on the fly', 'write executable on the fly', 'write executable on the fly', 'write executable on the fly', 'write executable on the fly', 'write executable on the fly', 'write executable on the fly', 'write executable on the fly', 'write executable on the fly', 'write executable on the fly', 'write executable on the fly', 'write executable on the fly', 'write executable on the fly', 'write executable on the fly', 'write executable on the fly', 'write executable on the fly', 'write executable on the fly', 'write executable on the fly', 'write executable on the fly', 'write executable on the fly', 'write executable on the fly', 'write executable on the fly', 'write executable on the fly', 'write executable on the fly', 'write executable on the fly', 'write executable on the fly', 'write executable on the fly', 'write executable on the fly', 'write executable on the fly', 'write executable on the fly', 'write executable on the fly', 'write executable on the fly', 'write executable on the fly', 'write executable on the fly', 'write executable on the fly', 'write executable on the fly', 'write executable on the fly', 'write executable on the fly', 'write executable on the fly', 'write executable on the fly', 'write executable on the fly', 'write executable on the fly', 'write executable on the fly', 'write executable on the fly', 'write executable on the fly', 'write executable on the fly', 'write executable on the fly', 'write executable on the fly', 'write executable on the fly', 'write executable on the fly', 'write executable on the fly', 'write executable on the fly', 'write executable on the fly', 'write executable on the fly', 'write executable on the fly', 'write executable on the fly', 'write executable on the fly', 'write executable on the fly', 'write executable on the fly', 'write executable on the fly', 'write executable on the fly', 'write executable on the fly', 'write executable on the fly', 'write executable on the fly', 'write executable on the fly', 'write executable on the fly', 'write executable on the fly', 'write executable on the fly', 'write executable on the fly', 'write executable on the fly', 'write executable on the fly', 'write executable on the fly', 'write executable on the fly', 'write executable on the fly', 'write executable on the fly', 'write executable on the fly', 'write executable on the fly', 'write executable on the fly', 'write executable on the fly', 'write executable on the fly', 'write executable on the fly', 'write executable on the fly', 'write executable on the fly', 'write executable on the fly', 'write executable on the fly', 'write executable on the fly', 'write executable on the fly', 'write executable on the fly', 'write executable on the fly', 'write executable on the fly', 'write executable on the fly', 'write executable on the fly', 'write executable on the fly', 'write executable on the fly', 'write executable on the fly', 'write executable on the fly', 'write executable on the fly', 'write executable on the fly', 'write executable on the fly', 'write executable on the fly', 'write executable on the fly', 'write executable on the fly', 'write executable on the fly', 'write executable on the fly', 'write executable on the fly', 'write executable on the fly', 'write executable on the fly', 'write executable on the fly', 'write executable on the fly', 'write executable on the fly', 'write executable on the fly', 'write executable on the fly', 'write executable on the fly', 'write executable on the fly', 'write executable on the fly', 'write executable on the fly', 'write executable on the fly', 'write executable on the fly', 'write executable on the fly', 'write executable on the fly', 'write executable on the fly', 'write executable on the fly', 'write executable on the fly', 'write executable on the fly', 'write executable on the fly', 'write executable on the fly', 'write executable on the fly', 'write executable on the fly', 'write executable on the fly', 'write executable on the fly', 'write executable on the fly', 'write executable on the fly', 'write executable on the fly', 'write executable on the fly', 'write executable on the fly', 'write executable on the fly', 'write executable on the fly', 'write executable on the fly', 'write executable on the fly', 'write executable on the fly', 'write executable on the fly', 'write executable on the fly', 'write executable on the fly', 'write executable on the fly', 'write executable on the fly', 'write executable on the fly', 'write executable on the fly', 'write executable on the fly', 'write executable on the fly', 'write executable on the fly', 'write executable on the fly', 'write executable on the fly', 'write executable on the fly', 'write executable on the fly', 'write executable on the fly', 'write executable on the fly', 'write executable on the fly', 'write executable on the fly', 'write executable on the fly', 'write executable on the fly', 'write executable on the fly', 'write executable on the fly', 'write executable on the fly', 'write executable on the fly', 'write executable on the fly', 'write executable on the fly', 'write executable on the fly', 'write executable on the fly', 'write executable on the fly', 'write executable on the fly', 'write executable on the fly', 'write executable on the fly', 'write executable on the fly', 'write executable on the fly', 'write executable on the fly', 'write executable on the fly', 'write executable on the fly', 'write executable on the fly', 'write executable on the fly', 'write executable on the fly', 'write executable on the fly', 'write executable on the fly', 'write executable on the fly', 'write executable on the fly', 'write executable on the fly', 'write executable on the fly', 'write executable on the fly', 'write executable on the fly', 'write executable on the fly', 'write executable on the fly', 'write executable on the fly', 'write executable on the fly', 'write executable on the fly', 'write executable on the fly', 'write executable on the fly', 'write executable on the fly', 'write executable on the fly', 'write executable on the fly', 'write executable on the fly', 'write executable on the fly', 'write executable on the fly', 'write executable on the fly', 'write executable on the fly', 'write executable on the fly', 'write executable on the fly', 'write executable on the fly', 'write executable on the fly', 'write executable on the fly', 'write executable on the fly', 'write executable on the fly', 'write executable on the fly', 'write executable on the fly', 'write executable on the fly', 'write executable on the fly', 'write executable on the fly', 'write executable on the fly', 'write executable on the fly', 'write executable on the fly', 'write executable on the fly', 'write executable on the fly', 'write executable on the fly', 'write executable on the fly', 'write executable on the fly', 'write executable on the fly', 'write executable on the fly', 'write executable on the fly', 'write executable on the fly', 'write executable on the fly', 'write executable on the fly', 'write executable on the fly', 'write executable on the fly', 'write executable on the fly', 'write executable on the fly', 'write executable on the fly', 'write executable on the fly', 'write executable on the fly', 'write executable on the fly', 'write executable on the fly', 'write executable on the fly', 'write executable on the fly', 'write executable on the fly', 'write executable on the fly', 'write executable on the fly', 'write executable on the fly', 'write executable on the fly', 'write executable on the fly', 'write executable on the fly', 'write executable on the fly', 'write executable on the fly', 'write executable on the fly', 'write executable on the fly', 'write executable on the fly', 'write executable on the fly', 'write executable on the fly', 'write executable on the fly', 'write executable on the fly', 'write executable on the fly', 'write executable on the fly', 'write executable on the fly', 'write executable on the fly', 'write executable on the fly', 'write executable on the fly', 'write executable on the fly', 'write executable on the fly', 'write executable on the fly', 'write executable on the fly', 'write executable on the fly', 'write executable on the fly', 'write executable on the fly', 'write executable on the fly', 'write executable on the fly', 'write executable on the fly', 'write executable on the fly', 'write executable on the fly', 'write executable on the fly', 'write executable on the fly', 'write executable on the fly', 'write executable on the fly', 'write executable on the fly', 'write executable on the fly', 'write executable on the fly', 'write executable on the fly', 'write executable on the fly', 'write executable on the fly', 'write executable on the fly', 'write executable on the fly', 'write executable on the fly', 'write executable on the fly', 'write executable on the fly', 'write executable on the fly', 'write executable on the fly', 'write executable on the fly', 'write executable on the fly', 'write executable on the fly', 'write executable on the fly', 'write executable on the fly', 'write executable on the fly', 'write executable on the fly', 'write executable on the fly', 'write executable on the fly', 'write executable on the fly', 'write executable on the fly', 'write executable on the fly', 'write executable on the fly', 'write executable on the fly', 'write executable on the fly', 'write executable on the fly', 'write executable on the fly', 'write executable on the fly', 'write executable on the fly', 'write executable on the fly', 'write executable on the fly', 'write executable on the fly', 'write executable on the fly', 'write executable on the fly', 'write executable on the fly', 'write executable on the fly', 'write executable on the fly', 'write executable on the fly', 'write executable on the fly', 'write executable on the fly', 'write executable on the fly', 'write executable on the fly', 'write executable on the fly', 'write executable on the fly', 'write executable on the fly', 'write executable on the fly', 'write executable on the fly', 'write executable on the fly', 'write executable on the fly', 'write executable on the fly', 'write executable on the fly', 'write executable on the fly', 'write executable on the fly', 'write executable on the fly', 'write executable on the fly', 'write executable on the fly', 'write executable on the fly', 'write executable on the fly', 'write executable on the fly', 'write executable on the fly', 'write executable on the fly', 'write executable on the fly', 'write executable on the fly', 'write executable on the fly', 'write executable on the fly', 'write executable on the fly', 'write executable on the fly', 'write executable on the fly', 'write executable on the fly', 'write executable on the fly', 'write executable on the fly', 'write executable on the fly', 'write executable on the fly', 'write executable on the fly']",1,0,0,1,
Q3CThh.5,8,"['OS info for a router', 'Get network interface', 'Get system info', 'Get CPU info', 'Check for Miner process', 'Check for Miner process', 'Get network related directory', 'Echo random stuff']",15,17,8,40,"['b37c0d927af8', '7d250f3c8f83', '64abb92a80b3', 'f813f92087f7', 'ed6cf781c12c', 'bc12e3f9eeb0', 'cc0b4b310901', '2cc1cf1df52a', 'd68758894c25', 'c51856eb24a0', '7dac5d879a95', '87bbdbf1dcf3', '050998b2d0a5', '48417a5ee857', '2b2dbaa37dd7', '0a91e9bd3a36', '24ca59a2655b', '67fcf3baa8e0', '8f3c755dfed2', '7a80f2c3b6de', '681f615af713', 'd8d2e5401e27', '765d42ab947a', '23d29a3a9b3f', 'b3e2ecdd2169', 'd60cec61573f', '2a1e217cfbdb', '0b28c1c803a5', 'eae84b233ca8', 'ab8ec00f1b6b', '947ec19c1624', '694c13b4d8f0', '009ae3b01a5e', 'f1aecb56f2d2', '47f4e895acb6', 'd8fb02151bba', '30f3ff434249', '7bb5f41142ce', '5b45f3bca8e3', '08902e4a7ae1']"
LLPb,9,"['spawn new shell', 'spawn new shell', 'enable shell builtin commands', ""print current process's executable""]",2,2,1,5,"['c23ee39f039f', 'b287aca73072', '9101b2261d64', 'be0c9ed6eaa6', '5cf98f2000e9']"
LLE1g,9,"['spawn new shell', 'spawn new shell', 'command: help', 'check for busybox', 'Download executable, execute']",1,0,0,1,
LLPG[b,9,"['spawn new shell', 'spawn new shell', 'enable shell builtin commands', 'System info', 'ping and spawn a shell', ""print current process's executable""]",0,0,1,1,['3b7c0dcc937e']
LL^g,9,"['spawn new shell', 'spawn new shell', 'Get root directory', 'Download executable, execute']",1,0,0,1,
